    81   200   235   209   194    43   237   169    91    64    27   125    37    68   105    50   202    48   113    43    24   190    53   230   193   168   168    25    37   201   230   239   144    68    15   135   169    26    99    70    16   226   134    42    72   209     1   199    48   214
   155    85   102    23   137   170    56    45    32   179   188    51    28     5   232   168   177   145    19   134   168   142   202     5   123   144   186    24    38   139    95   169   160   176   154    75   143     6    46    34   165   196   142   124   204   221    57    21   219     5
   157   213   206    89   117    62   187   130   106   207    13   209    32    12   111    40   202    62    29     9   174   200   144   108    89    76    31    91    50    59   134    78   188     4    25    86    27   195   134    14   167   122   119   207    38    13     3   127    70   210
    42    87   181    17    13    77   125    94   215   130    39   234    80    34    28     1   189   146   121    80    63     1    29    72    63    38    81   107     1   115    62   142   220   218   159   123    19   108    54   188    53   146   162   140   233    10    83    57    82    87
   162   211    35   127   116    97    25    21    90   147   222   137   122    52    38    39   134    47   175    11     5   207   104    17   116   145    37   112   186   139     2   135   131   147   203    13    82   239   217   160   156   176    22    64    95   125   166   183    29    73
    40    22    68    95   238   193   211   118   233   142   105    14    28    70    62   165   213   167   226   138     9   188    33    58   229   147    95    23   169     6   134    48    48    44   224   179    40   167   163    30    49   192   216     2   165   102    28   213     5   110
   101   180    81   186   231    48   214    24   131    65   222   213   223   238    96   140   230   129    44   193    23    87   117   105    72   172   228   239   122     1   233     5   204   153    27   217    36   195    76     9   223     8   150    70    83   180    34    39   185   175
     5   100   199    42    85     4   163    96   233   118   235    58   179   203   188   159     2    71   153    54     3     1    63   164   134   217   146    88    72    66   107   195     2   122     6   122    58   134   103     1   169   233   116   141    63    13   212    32   163    16
    48   169    92   222    86    16    70   159   133    53    26    80   111    69     2   143   119    71    67   158   229     1   106   135   114   127    44     1   106   119   105    12   143   182     7   178    42   102   108    31   199   209   215   205   219     6    45    52   194   138
   201   227    88   192   218   181   220   191   218   218   212    83   206   168   158   216   126   194   127   195   162     1   201   164    67    70   239   171    36   193   132   231   224   204   147    49    14    86   136   125   132    36   156   141   128    63   199    69    89   201
   172   216   178   221   214   174    55   105    26    38   118   230    73    96    40    54    27   149   135   232    74    46   119     2   152    64   187    64    69   111    83    76    28   165   220   151   147   141    32   184    94    24   231   113    35    25   185    55    77   203
    66   133   232   172    96    48    15    84   173   145    16   147   138    53   221    52   194   113   151   124   176   186   159    50    36   157    24   112   129    24    35     2   157     6   121     1   184   214    45   195   207   121    96    17    48    17   196    75     7   125
    97     3   175   188    65    71   206   158     1   128   197   193   196    57   224    26   174   129   199   110   206    96     2   230   196   169   174   194     1   216   149    61   133    23   232    93    82   213   174    61     1    38   209    32    66   207     6    87    15   206
    14    46   193    94   132   155   153   184    20   118    29    51   129   127    35    26   106   225   192     5   154   170    96   151    30    89   165   201   152   165    67   180    39   165   163   157    44   196     1   144    37    25    46   148     1     6   203    28   100   133
   227    74    80   111   101     5    11   176    51   195   218    66    15   109    99   198   204   184    67     4   100    77    65   194   167   213    84     1   107   200    70    20    74    43    28   126    78     1    80    67    96   120     7    61   220    82   173    53   126   107
   207    41    50    19   215   102   219   225    17    16    91   181   168     4   145    90    98   171   215     4   172     3   227   153   181    60   136   136    50    56    47    14   229    48    69    98   219    80   228     5    26    30     8   182   230    91     3   107    76    30
   189   119    55    71   204   108     2   182   147   130   130   220    80   128   204    50   160     2    44    87   182   215    79   235    43   213   228   168   104   169   127   237    73   190   128     2    71   150    52   115   150   151   118   134    91   227    58    43   211    56
   199   145   189    25    49    21    17   114   101    38   186   142   167    36   113   135    23    78   233   176    94   120   176     1   213   217   130   218   148    23   164   125    64   137   189    79    86    73    56   199   117   199    69     1    13    90   120   183   188    67
    91   158   180   197   207    93   219    88   150    48   194   160    93   133    13   205   159    91     6    72    71   190    88   178    19   158    95   222   212   152    41    42   105   214    39    62    91   108    68   102   133   116     1     3    63   157    82    26   237    96
    71   128   175   118    88   160   223   140    18   222   176   211   185   219   206   220    91   223    55    53   182   131    28   157    65     5   108    25   238    56   129    61    31   192   166    78   130    46    14   111    63   235    27   194   210   114   232   129   210   119
