    33    16    71    86    83     9    90    17    98    28    74    20    87    39    92     8    80    99    89    89    17    80    72    42    98    88    23    91    70    49    43    94    38    97    11     7    26    59    16     6    11    43    49    38    52     6    96    75    15    11
    64    42    27    79    35    75    55    49    42    33    96    23     9    77    71    29    57    96    40    85    70    20    20    45    23    89     6     1    18    10    35    75    13    54    72    61    74    27    60    54    78    92     6    54    21    89    61    92    11    92
    65     2    40    83    88    42     1    60    86    83    73    78    37    17    78    10    48    35    27    20    26     2    29     8    78    68    86     7    54    40    65    47    44    97     1    42    86    49    53    16     5    98    82    77    87    24    80    59    13    74
    17    20     6    38    36    70    19    66    75    38    80    75     7    92    39    82     5    35    55    86    32     6    64    38    52    29    63    91    39    66    77    36    89    55     8    62    54    22    49    20    16    11    12    80    97    33    21    67    33    46
    67    84    94    29    87    94    31    53    14    36    33    72    52    80    46    49    48    91    42    36    40    75     2    66    10    91     4    93     8    79    73    58    37    91    21     7    61    91    81    92    92    88    90    73    57    34    27    88    50    85
