    16     8    35    43    41     4    45     8    49    14    37    10    43    19    46     4    40    49    44    44     8    40    36    21    49    44    11    45    35    24    21    47    19    48     5     3    13    29     8     3     5    21    24    19    26     3    48    37     7     5
    32    21    13    39    17    37    27    24    21    16    48    11     4    38    35    14    28    48    20    42    35    10    10    22    11    44     3     1     9     5    17    37     6    27    36    30    37    13    30    27    39    46     3    27    10    44    30    46     5    46
    32     1    20    41    44    21     1    30    43    41    36    39    18     8    39     5    24    17    13    10    13     1    14     4    39    34    43     3    27    20    32    23    22    48     1    21    43    24    26     8     2    49    41    38    43    12    40    29     6    37
     8    10     3    19    18    35     9    33    37    19    40    37     3    46    19    41     2    17    27    43    16     3    32    19    26    14    31    45    19    33    38    18    44    27     4    31    27    11    24    10     8     5     6    40    48    16    10    33    16    23
    33    42    47    14    43    47    15    26     7    18    16    36    26    40    23    24    24    45    21    18    20    37     1    33     5    45     2    46     4    39    36    29    18    45    10     3    30    45    40    46    46    44    45    36    28    17    13    44    25    42
