    81   200   235   209   194    43   237   169    91    64    27   125    37    68   105    50   202    48   113    43    24   190    53   230   193   168   168    25    37   201   230   239   144    68    15   135   169    26    99    70    16   226   134    42    72   209     1   199    48   214   107    11   151    95   130   131    88    56    21   152    72   103   123   204    67    72   210   211   163   138    66   160    71   182   136   115   136    27     4    83    65   152    40    77   105   198   205   213   217   140    98   111   222   149    94   137   124   184   216    23   163     3   135   193   145    19   148    42   162     5   200   163   124   219     1    90    11    34   171    26     5   192   111    86   195    82   170   116    51   177    89   194    83   206    63     2   143   237    70   170    66   167   234   176    66     7    88   109    41   226     5   148     6    70   162    41    91   102   109    22   141   142   217   160   146   229    56   234    15   143   164   192   126   103    85    59    75   153     6    90    47   131   186    73   120   122   234   129   235   231    10   202   193   102     5   200    66    90   211   160
   155    85   102    23   137   170    56    45    32   179   188    51    28     5   232   168   177   145    19   134   168   142   202     5   123   144   186    24    38   139    95   169   160   176   154    75   143     6    46    34   165   196   142   124   204   221    57    21   219     5    61   181    32    35   204    18   208   237   183   167   156   229    55   151   197   110    48    89   233    77    94    21    17   176   221   154     1    39   123    50   108   136   151   146   212   142   222   228   194   231   178   182   144    59    35    41     2    24   140   143   108    19   222   179   147     5   214    32    95   216    63   211   108   228    75   209   239   139   218    57   125    62   238    70    20    47    32   191     8   148     7   117    20    83    93   214    19   202    24    76   118   165   227    96   211   203   151   224   182    77    92   170   215   220   170     1    50   115   229    15    74    91    40   215    82    32   168   170    71    27   142    36   136    15   167   146   196   217     4   191    62   190   223    82   137    83    37   227   222     1    96   184    20   183   120     2   239   177   194   226
   157   213   206    89   117    62   187   130   106   207    13   209    32    12   111    40   202    62    29     9   174   200   144   108    89    76    31    91    50    59   134    78   188     4    25    86    27   195   134    14   167   122   119   207    38    13     3   127    70   210   199   153   173   157   168    82     3     5    64   228   210    16   133   172   197    75   149   190    14    48    96   188   217   166   111    14   232    59    81    32   123   233    73   141   201   229    52    83     7   239    27   111   144    88    84    17   117   186    82    86   118   229   188   203     1    38   186    53   238   181   119   127    82   218    98     9    59   220   168    27    41    91   178   105    37     4    52   177    19    98     3   182   189    22   152   208   100   188   194   113   115   161   214    84   163    64    78    63   184    67   219    37   235    29   234   119    53   168    31   168   138    92   182     7   121   223    75    45     1    92    31    40    23   152   239   187   210   102    99    16     5    83    93   119    20   156   194   186   231   226   131   232   151    19    80    50    90   158    23    92
    42    87   181    17    13    77   125    94   215   130    39   234    80    34    28     1   189   146   121    80    63     1    29    72    63    38    81   107     1   115    62   142   220   218   159   123    19   108    54   188    53   146   162   140   233    10    83    57    82    87    79    81   225    82   226   237   236   236     6   190    54   217   133   231    85   159    31   130   152   137   234    21   165   174   201   130   173    64    18   158   234    12   200   179     8     9     5     2   163    71   170   193   170   154   176   155   178   137   123    92   122   102   183     3   123   184    59   126    89   213    73    87   196    86     9   108    37   235   236   119    89   143   123   141    85   220   132    30    12   101     9   141    98    97    56   147   199    78   145    75   142    38   149    92   183    41   225    28   155    99    58   187   222   234    20    54    25   125    89   116   220    55    20     6    17   166    62    68   176   109   147    75   163    79   175   155   123   102    62   196    29   239   124    18   238   190    46   227   218    68   236   107   117   136   131    99   223   126   115     3
   162   211    35   127   116    97    25    21    90   147   222   137   122    52    38    39   134    47   175    11     5   207   104    17   116   145    37   112   186   139     2   135   131   147   203    13    82   239   217   160   156   176    22    64    95   125   166   183    29    73   149    93   148    30   142   141    35   141   211     1    43    22   122    32     7   177   193    91   220   154     1    89   227    14   172   196   122   142   180    63   174    34   211   188    54   196   102   221    57   222     2    60    59   217   193    30   190   148   195    51   229   194   163   222    61   151    98   180   195   113    42   208   214    69     1    72    29    60   178   204   130    12   153    73   141     1   190    16   113    76    32   238    27    68    91    44    81   210   201   179   124    61    57   222   183   110    40    89    33   113   223   134    67   179    19   223   170   112    97     3   212   148   151   228   122   148    30   237    67    48   146    67    49   112   115   121   117    54    33   217   226   236     2   209   227   187   141   128   149   157    23    17    84   193   199   103    52   124   118   141
    40    22    68    95   238   193   211   118   233   142   105    14    28    70    62   165   213   167   226   138     9   188    33    58   229   147    95    23   169     6   134    48    48    44   224   179    40   167   163    30    49   192   216     2   165   102    28   213     5   110    10    14   239    48   165    55    71   186   237     8    62   140    30    67    32   209   216     2    53    29   103   120    34   236   234   187    11   183   231    30   146    59   146   190   186    28    55   185    47   235    49   217   110    62   166   160    99   197    73   121   131   232     3   167     1   110   202    39     1   165    51   119    76    24   229   207    96   176   127   190   162    80    45    20   188    91    29   209    43    90    87    11   197   130    35   120   223   163   170   220   193     1    43   143    46   134   227   185     1   225   141   135   197    97     6     2   205    83   125    74   109    97    43    13    72     4    40   155    60    89    98     8   209     4   169   143   135     3    75   234   120   175    71   166    25    20     7    74    10   155   106   131     6    59   197    26    29   120    99   121
   101   180    81   186   231    48   214    24   131    65   222   213   223   238    96   140   230   129    44   193    23    87   117   105    72   172   228   239   122     1   233     5   204   153    27   217    36   195    76     9   223     8   150    70    83   180    34    39   185   175   215    98   211   206   205     7    23   191    13   126   183    17    26    44   237   138   173   163   183   183     1    17    36    95   199   191    64   133   231   111   167    98   118   188   175    55   208   196   227     1   115   151     8   159     7    81   140   108    56    72   160    81   222    83   177   114    16   181     6   225   105   142   173   158    35   186    67   166    87    21   171    77   173   138    26   114    15     1   217   120    80    11   132   217   164   162   215    43   234    60    20    60     6     4    42   120   236   171   210    76   206   209    74   101    30   201    48   228    93   107     3    56    84   213     3   217    35   171   134   236    63   131   227   136   211   164    95   175   179   148   120   172   165    16   140   178   197   186    72    43     1   230     2   188   131    26   213    85   193   236
     5   100   199    42    85     4   163    96   233   118   235    58   179   203   188   159     2    71   153    54     3     1    63   164   134   217   146    88    72    66   107   195     2   122     6   122    58   134   103     1   169   233   116   141    63    13   212    32   163    16    34    82    49   162    90   157   111   122   233     1    85   196   191     7    14    26   155   183   118   193   224   199   180   134    85    43   220   229   172     7   190    35   201   193    52    76   233    16    94   227   110   205   211    79   140     7   181   151   189   222    56   233    58   152   235   192   126   164    97    85   136   233   114    86    42    68   228   143     1   164   101    97   205   225    12    76   120    97   209   192     1    73    47    12   229    83     4    86   127   139   222    72   126    91    25   189   212    13    64     5   207   165   123   173    27     6   198    96    26   122   103   194   172    57   159   174   223     4   196    94    33   213    48   218   233   235   184   212    46    27    56   233    80   165   102    99    50   223    24    84    17   228   123   157    35   118   150   182   167   229
    48   169    92   222    86    16    70   159   133    53    26    80   111    69     2   143   119    71    67   158   229     1   106   135   114   127    44     1   106   119   105    12   143   182     7   178    42   102   108    31   199   209   215   205   219     6    45    52   194   138   169   212    48    46    19     3    25    93   126   104    44     1   105    83    58    77   132    55   235   154   164    10   188    71    58   228    47    37   194    71   190    90    59    90   130   233   139    28    86    67    47   207   171   176    16   195     1    60   223     3     5    27     7   180   140    74   173   194    10     4   192   104    63   139   158   204    15   154     2   136    25    25     1   142   196   107   157    83   109   125   223   178    11    59   133   138   162    29    83   201   233   165   164   129   197   185    46    80    39   130   151   193    61   100   163   145   239   101   171    38   124   193   121    57   209   185    20   160   101    63   226   156    99   228    69   153    68   155   222   127    44    86   116   161   193   210   154    73   177   100   125    39   230     9   103   221   159    14   200   207
   201   227    88   192   218   181   220   191   218   218   212    83   206   168   158   216   126   194   127   195   162     1   201   164    67    70   239   171    36   193   132   231   224   204   147    49    14    86   136   125   132    36   156   141   128    63   199    69    89   201   177   133     3   171    91   143   124     1     1     3    74    96    73   133   212    83   177    85    95   147   130   220     3   209   111    48   167   118   106   109    56   108   205   166   142   211    44    19   198    13    67   216   184   220    24    48   194   134    83   158   204   200    56    53    40   238   218    29    38   178    25     5    30   199   219   234   114   195   200     1   125   119     4    33   117   125   210    34    47   136    59     5    91   167     1   238   198    51    45    14    99   102    88    75   228    86   156    65    41    21    77   159   178     9    18    31    53   200    16   113   103   160   206   155   238     2    33   113   169    88   135    95   185     8   216   217   185   185     7   211   122   181   124   216    79   138     6   216   114   183    90   195   219   111    71   119   170     7    49   235
   172   216   178   221   214   174    55   105    26    38   118   230    73    96    40    54    27   149   135   232    74    46   119     2   152    64   187    64    69   111    83    76    28   165   220   151   147   141    32   184    94    24   231   113    35    25   185    55    77   203   167   189     2   119     7   205    62   227    22    24    13    18     7   172   162   107   173    11    71    28    95    63   177   225   108    67    48   150    47   236   224    69    80   190   236    84   190    20    40    14    43    86   201    24   235    26   152   114     2    79    40   205    39    77    82    94   233   165   211    44     6   103    88    78   116    85    29   155     3     2   193   171   207    65   124    77   172   124    21   130   170   179     8    36   189    59   199   236    99   181    31   137    34    20    85   111   100     1    33    72    68   171    29    17   174   144   156    44   180     8   122   236   206   232   147     3    94    27   138   218   161   201   145    54    11    71    33   141   108   220     1   201   113   145    34    24    73    40   215   150   141    70   178    31    72   237    69    33    26   167
    66   133   232   172    96    48    15    84   173   145    16   147   138    53   221    52   194   113   151   124   176   186   159    50    36   157    24   112   129    24    35     2   157     6   121     1   184   214    45   195   207   121    96    17    48    17   196    75     7   125     4   228   162    42   233    12    91    21    97   226    33   142    26    44   139     2    86    80   144     9   141   195    98    12   117    94    89    38    76    95   100   144    26   111   111   127    70   153    46    50   178   155    59    16   132   145    75   238   238   174   229   131   234    56   150   189   105   151   220    67   232     7    55   134   152   170    93   127   155    40   137   115    39    38   199   188   196   181    31   209    35   106   117   223   236   136    80   160    96   144   107    70     1   237   153   222   187    97   123   206    77   162   115   175   237   168     6   195    41   197   145   204   162    16   149   224   119   220   220   101   189   220   164   176   111   148   131   200   161     3   207     3   148   213    77     8   102     4   175   172    94   117    70    94   119   125    73   187    68    36
    97     3   175   188    65    71   206   158     1   128   197   193   196    57   224    26   174   129   199   110   206    96     2   230   196   169   174   194     1   216   149    61   133    23   232    93    82   213   174    61     1    38   209    32    66   207     6    87    15   206   129   184   135     1   134   182    91   104     9    74    40    98   124     5    58   103    82    44   176   123   124   219   177    21    82   217   108   190    41    76   209   238   213   115   154     4   179     3    99   169   164   176    82   225   117     5   174   156   169   153    43   174    63    26    84   188    70     1    70   194   159     9   148     1    14   126   196    82   153    84     6   183   199    82   101   113   221    61    84   133    81    71   189    32   146    51   127   100    71    24   235   229    60   174    26   167    55   134    92    26   112   110   181   185   107    64    26   182   143   156   239    98   120   237    39    61    81   170     1   127    18    16   230   216    74   192    90    41   155   219    57   157    43   226    19    70   165   189   100   158    10   177   179   102   219   112    75   180    52   182
    14    46   193    94   132   155   153   184    20   118    29    51   129   127    35    26   106   225   192     5   154   170    96   151    30    89   165   201   152   165    67   180    39   165   163   157    44   196     1   144    37    25    46   148     1     6   203    28   100   133   174    69   209   144   162   179     1    31    94    57     4    70   222   179   166   151    81   217   148   226    42   102   184   178   207   234    68    61   213    36    58   155   236   160    68   137   152    10   205   204   196   239   217   227   191   196    50   162   141   236   216   122   117   212   127    84     2   219    25   227   197   148     2   148    22   229     8   236    63   183    35   183    81    49   119   183     1    50    55   147    41    10   209     3   148   205   160    88   158    13   176     4   139     5   199   107    24   130    19    44    43    68   136   154    21   177    86   189   136   116   206    56   204     3    88   233   226   147   211    91   126    23   193   129   173   108   173     1    54    32   136   171   194   147     2    37   191     5    39   146   158   227   117   211   174   106   184   208     6   174
   227    74    80   111   101     5    11   176    51   195   218    66    15   109    99   198   204   184    67     4   100    77    65   194   167   213    84     1   107   200    70    20    74    43    28   126    78     1    80    67    96   120     7    61   220    82   173    53   126   107    72    27   233    91     1    15    56   173   207     9   216   105   188    59   130   147   192   229     1   132     6    29   223    69   204    38   224   138   205    97   107   117    33   168   160    62   215   112   126    66   124   125   137    38   100   147   131    61   199   196   183   113   238   220   203   159    94     2    44   136    84    52    45   177    34   236   176    28   214   167    95    19   202    17    87    79   210    86   220   123   227    49   238   147     8    83    13   132   239   164    42   150   149   153     2    93   157   140   102    29     6    97   204   184   155    67    25     7   172    88   221    41    85    39   115   143    62    16   197    30   136   182   142   167   160   151    21     5   100    95    90   233    81   134   214   159   185   123    96   151   119   198   166   167    77   149    55   144    44   149
   207    41    50    19   215   102   219   225    17    16    91   181   168     4   145    90    98   171   215     4   172     3   227   153   181    60   136   136    50    56    47    14   229    48    69    98   219    80   228     5    26    30     8   182   230    91     3   107    76    30   123   228     3   129   223   235    73    41   116   133   157    78   184   223     5   125    46    17   126   212   205   141   219    32    36    44    16   161   186   156    73   170   203   224   213   209   193    63   170   212    58   206   193   131   207   160   130   172     6   108    34   195   111   239   107   187   163    22   219   139   163    71   131   161    44   189   175     9    51   224    33   137   217   228   108     1   206    82   236   119    53   108   127   179   208    42   200   184    59   142    96   234    58    46   225   171    54   115    38   160    74    72   153    12   160   139    91   126   181   131    50    33   213   138    41    60     7   131   205   149    32    55   132    88   159   197   135   237   190    36   148   189    87   116     4    74   159   146    44   105   202   167   223   103   122   180   196   228    25   103
   189   119    55    71   204   108     2   182   147   130   130   220    80   128   204    50   160     2    44    87   182   215    79   235    43   213   228   168   104   169   127   237    73   190   128     2    71   150    52   115   150   151   118   134    91   227    58    43   211    56   213   118   177     1   102    39   191    65    26   180   198   129    87   189   121    91   230   166   176   130    31   222    37    77   217   213    96   104   195   132    43   201   114   159   218   193    19   188    57     1   138   172     1    11   130     8   175     3   203    88    82   144   189   112   154     7   187   121   200    29   143    38   158   153     3    23    72    52   106    87   118   117     9    17   115   127     2   208     1   171    45   238     3    97   117    18   121    86   221   112    85    83     2     5   190     9   120   154   163   227    69     4    94   187    21    38   146     1   150    72   219   121    54   169    18   180    66    62     9    41    84    41    98   207    40   223   146   104   118   125   140    83    60   214   218   216   180   141   109    53   193    96   120    43    71   164   169   132     2   136
   199   145   189    25    49    21    17   114   101    38   186   142   167    36   113   135    23    78   233   176    94   120   176     1   213   217   130   218   148    23   164   125    64   137   189    79    86    73    56   199   117   199    69     1    13    90   120   183   188    67    71   173   150   208   239    23   143    91   146   147   101     1    38   126    25   208    41    71   223   171   207   125   168   135    25    47   175    16     1   149   159   231   106    40   182    24    51   209   117    61    83   131   140   155   114   115   197    59   106   127   225   104     5     8    66   200    83    90   166    84   199    78   122     3   147     1   239   120   209    45    72   121   169    41    21   197   186   175    55    83    62    16    21   181   113    22    25    39   232   195   150   160   164    26   140   220    76   153     1   169   112    48   133   213   212    58    81   117     3   118    22     5   186    13     2   184    45   238   200   121   184   199   164   202    26   108   229   155    83    63   219   102   126   146   132   213   105   120    16   154   146   210   216     1    60   229     9   185   154    23
    91   158   180   197   207    93   219    88   150    48   194   160    93   133    13   205   159    91     6    72    71   190    88   178    19   158    95   222   212   152    41    42   105   214    39    62    91   108    68   102   133   116     1     3    63   157    82    26   237    96   162   208    40   134   230   123    56   185   198   161   239   106   221   180     7   124     6     2    92     5     8   182   154   102   211   172    47    87    76   215    79   163   176   175    62    93    71   214   224    91    60   136   178     3    33   215    31     1    95   169   116   226    36    36   209   153   194    12   189   152    20   176   143    98   135    68   107    19   120   144   101    49    95    35    21     3    64    81    81   168    59    17    48   157   149    46     1     1   190   199    97    33    30   134    64   173   179   135   181   238    39    77    62   171   229   130   226    11    12   182   171    15   102    50    98   229    42   213    87     4    58     1    98   104    94   144   205    81    70    40   204   227   171    17   186   222    51   182   211    74    68   234   163    49    17   190   115   223   148    11
    71   128   175   118    88   160   223   140    18   222   176   211   185   219   206   220    91   223    55    53   182   131    28   157    65     5   108    25   238    56   129    61    31   192   166    78   130    46    14   111    63   235    27   194   210   114   232   129   210   119   218    48    56    55   170   231   231    87    92    39   131   162   213    45    99   228    35   159    59    71    63     2   139   199   142   226    53    54    24    61    72   229    54   157    14    78   205    87     9    68    52   221     1    58    52    68   229   197   230   130    95    10    82   124   133   107     7    19   169   103   152    78     8   144    66    35   175    31    55   135   235   163    55    78   126    70    88   207   202   143   101   204    11    42    74   120    14   155   213   139   183   216     8   200     4   167   182    58   209   230     8   211    22     3    53    11   226   196   104    27     3   138    67    66    91    31   120    54   210   186   197   102   177   187   151   121   102    61    65   196   172    35     1   101    51    78   154   134   188    90   158   203   112   189    99   226   133    13   104   136
