   271   669   784   697   646   143   790   566   305   214    93   418   123   228   350   168   675   160   377   144    81   634   178   769   643   561   561    84   125   670   769   798   480   228    52   451   564    87   332   233    53   755   448   143   240   699     4   664   160   714   356    37   505   317   434   439   295   187    72   509   242   345   410   682   225   241   700   705   545   461   222   535   238   607   455   385   453    91    13   277   217   509   135   257   350   661   684   711   723   469   329   373   741   499   315   459   413   616   722    79
   517   284   341    77   457   567   188   150   109   599   626   172    95    19   773   560   592   484    63   449   563   475   674    19   412   483   620    81   128   463   318   564   534   589   514   251   477    20   153   114   552   656   474   415   682   737   192    70   730    18   203   603   106   118   683    60   694   790   611   557   521   765   184   506   658   369   160   298   777   257   316    70    56   588   738   515     5   133   412   167   363   456   505   487   707   475   741   761   647   771   596   608   480   198   117   137     7    82   468   476
   523   710   689   298   391   208   625   436   354   693    43   698   108    40   372   133   674   207    98    31   581   667   482   361   297   256   103   306   169   198   447   261   628    13    86   287    90   651   446    49   558   408   397   691   127    44    11   426   236   700   666   512   577   525   563   274    12    19   214   761   702    54   444   573   659   250   499   635    48   163   321   629   725   554   372    47   775   197   270   106   412   777   243   471   672   763   174   278    24   796    92   373   482   296   282    58   390   623   276   287
   140   292   604    59    45   258   416   316   719   434   130   780   267   113    95     1   631   486   405   267   210     6    99   240   211   127   270   357     5   384   208   476   736   727   530   410    65   361   180   629   179   489   540   468   778    34   279   191   276   292   264   270   751   276   753   790   787   789    21   633   181   726   443   771   285   532   105   435   506   458   783    71   550   580   670   436   579   215    62   528   782    40   667   598    29    32    18     9   546   239   568   644   568   515   589   518   593   457   411   307
   540   703   119   423   389   326    84    71   300   491   742   459   406   174   129   132   449   158   585    36    18   691   347    59   389   484   126   375   621   464     8   450   439   492   677    44   275   799   724   536   521   587    73   213   319   418   556   611    99   246   499   312   495   101   474   472   117   472   705     4   144    73   409   106    25   591   646   304   734   515     4   298   757    47   574   655   407   474   602   212   581   113   703   627   181   656   342   737   192   741     9   200   199   725   643   101   634   493   651   173
   133    75   227   319   795   644   704   394   777   475   350    49    94   236   207   551   711   559   756   460    33   627   111   195   764   490   319    78   563    21   449   160   160   148   748   598   133   556   544   102   166   642   721     7   552   340    94   711    17   368    36    47   799   161   551   186   238   622   792    29   207   468   102   224   108   697   723     7   178    98   344   401   114   789   780   626    38   610   771   102   488   198   488   633   621    95   185   618   156   786   163   725   366   208   554   536   331   657   243   405
   336   600   271   622   771   160   714    82   437   219   742   712   743   796   320   469   767   431   149   645    76   292   393   351   240   573   761   799   408     5   776    16   681   510    90   724   122   652   256    32   745    26   500   233   279   601   114   130   617   583   719   329   705   689   683    26    77   637    43   421   610    57    87   147   790   462   576   544   612   611     1    59   122   318   664   638   214   445   770   370   559   328   394   629   584   186   693   655   758     6   385   505    29   532    24   272   467   362   188   241
    16   336   665   141   284    16   546   320   777   396   785   195   599   678   628   530     9   238   511   182    13     1   212   548   447   723   487   295   240   221   359   653     7   406    21   409   195   447   344     4   564   778   388   470   211    45   706   109   546    54   114   274   164   541   302   526   370   407   777     5   285   654   637    25    47    89   519   611   396   643   748   663   602   446   286   144   733   766   575    23   636   119   673   643   174   256   778    54   314   756   369   684   704   265   469    24   605   506   631   742
   162   566   309   742   287    55   234   532   446   179    88   268   371   233     8   479   398   237   224   527   765     4   355   453   381   425   147     5   353   398   350    41   478   606    24   593   141   342   362   103   664   697   718   683   732    21   150   175   647   461   564   708   161   154    65    10    85   312   422   348   149     4   352   278   193   256   443   184   785   516   547    35   629   238   196   762   158   126   647   239   636   300   196   301   435   777   465    94   287   224   159   690   571   586    56   650     3   201   745    10
   672   757   294   641   729   605   734   639   729   728   708   279   687   560   527   722   422   647   424   651   542     5   672   546   225   235   798   570   122   643   440   770   749   680   491   164    47   288   455   419   442   120   520   472   428   210   665   232   298   672   592   444    10   572   303   476   414     2     3    12   248   322   244   443   707   278   592   285   319   490   435   736    10   697   372   160   559   396   354   365   189   362   683   555   473   705   148    65   660    44   223   721   615   736    81   160   649   449   277   529
   574   721   596   737   713   583   186   351    89   128   395   769   243   320   135   182    90   499   452   775   248   154   398     8   507   213   625   213   231   372   278   256    96   550   733   505   492   471   109   615   313    80   770   378   116    84   616   186   256   676   559   631     9   397    25   685   209   758    76    81    44    61    24   574   541   357   579    38   237    94   316   212   590   753   361   223   160   502   157   786   746   232   267   635   789   281   633    69   136    49   145   288   670    83   786    86   509   383     7   263
   221   444   775   574   320   160    52   280   578   484    54   492   461   177   739   175   647   377   504   415   587   623   531   169   123   526    81   374   432    81   118     9   524    21   404     2   616   713   153   650   692   406   321    59   163    59   655   252    25   417    16   763   540   140   779    42   304    72   324   753   112   473    88   147   463     7   286   269   482    31   472   650   329    41   392   316   298   128   254   318   333   481    87   371   370   423   234   511   154   168   595   518   197    56   442   485   252   794   793   582
   325    13   584   629   219   238   689   527     5   428   657   643   654   191   749    87   581   430   664   368   687   320     9   768   654   563   580   649     1   721   497   205   445    76   774   311   274   712   580   205     5   126   699   108   222   692    20   291    51   686   431   616   452     1   449   609   303   346    32   249   133   328   416    19   194   343   274   149   587   413   416   731   590    72   275   724   360   635   137   255   698   794   711   385   514    15   599    12   330   563   548   587   274   751   393    19   580   522   566   510
    48   156   644   316   441   517   510   616    69   396    99   172   432   425   119    89   354   752   640    18   515   569   322   505   101   298   552   672   508   551   223   603   130   552   545   523   147   655     5   481   123    85   153   494     4    23   678    96   335   446   580   232   699   481   541   599     1   105   313   192    15   235   740   598   556   506   272   726   493   753   140   343   616   595   693   780   227   205   712   122   194   517   788   536   227   459   508    36   685   680   654   799   725   758   637   654   169   541   470   789
   759   248   268   370   338    18    39   589   171   651   727   221    53   363   331   661   680   615   224    16   335   256   217   648   558   712   282     5   359   668   233    67   248   146    96   421   260     4   268   223   320   400    25   203   734   274   577   178   422   358   240    92   779   305     1    52   187   578   691    30   720   351   628   198   433   491   641   764     3   442    21    98   745   230   680   127   746   460   684   324   357   390   111   562   536   207   717   373   421   220   414   417   459   129   333   491   438   203   664   655
   690   138   167    65   718   341   730   752    59    54   306   604   562    15   484   300   329   571   717    15   575    12   758   510   605   202   455   455   167   187   158    46   766   160   230   327   732   267   761    19    88   100    26   608   768   305    11   357   255   100   412   761    13   431   745   786   244   138   387   444   525   261   614   743    19   419   156    57   420   707   684   472   730   109   120   148    54   538   621   522   245   567   678   749   711   697   645   210   568   709   194   688   643   437   690   533   435   575    20   361
   632   398   185   237   682   361     8   606   490   434   433   736   269   428   681   169   533     8   148   293   608   719   265   783   144   712   761   562   348   564   426   790   244   636   429     7   239   500   174   383   500   504   394   447   304   759   195   145   704   186   712   393   590     1   342   131   638   218    86   602   662   431   293   633   405   306   767   554   588   435   105   742   125   259   726   711   320   349   652   440   144   672   382   531   728   643    63   629   190     3   460   574     5    39   435    26   586    10   678   294
   666   484   631    84   165    71    59   381   337   129   623   475   557   122   379   453    76   260   779   588   315   400   588     3   711   724   433   729   494    76   548   417   213   459   633   266   289   244   189   664   392   665   230     1    44   302   400   612   627   226   238   579   500   696   797    79   479   306   488   490   337     5   129   420    85   695   138   237   744   571   692   416   561   450    83   157   584    54     4   499   531   772   354   133   606    81   172   697   391   206   279   436   467   519   381   383   658   199   354   425
   305   529   601   658   692   311   730   295   501   161   647   536   310   444    44   684   531   304    21   240   238   634   293   595    64   526   317   741   708   508   137   142   353   715   131   208   304   361   226   342   443   388     5    10   210   524   274    89   791   322   541   695   133   446   769   411   189   619   660   537   797   355   738   600    24   414    21     9   309    18    27   608   513   341   706   573   157   293   254   719   266   546   589   584   207   310   237   713   746   304   201   456   596    12   112   716   106     5   318   566
   236   427   583   394   294   535   744   468    63   742   587   706   618   733   689   735   305   746   183   178   609   437    96   525   217    17   362    83   794   188   430   204   106   641   556   260   436   155    46   370   213   784    90   647   700   383   774   432   702   398   726   162   189   186   568   772   771   292   309   131   438   543   712   151   332   760   116   530   197   239   210     8   463   666   474   754   179   181    81   206   240   765   181   523    46   262   683   290    32   228   175   736     3   195   176   228   764   658   769   433
