   169   418   490   435   404    89   494   353   190   134    58   261    77   143   218   105   421   100   236    90    51   396   111   480   402   351   351    53    78   419   481   498   300   142    32   282   353    54   207   145    33   472   280    89   150   437     2   415   100   446   223    23   315   198   271   274   184   117    45   318   151   216   256   426   140   150   437   440   340   288   139   334   149   379   284   241   283    57     8   173   136   318    84   161   218   413   427   444   452   293   206   233   463   311   197   287   258   385   451    49
   323   178   213    48   285   354   117    93    68   374   391   108    59    12   483   350   370   302    39   281   351   296   421    12   258   301   387    50    80   289   199   352   334   368   321   157   298    12    96    71   345   410   296   259   426   461   120    43   456    11   127   377    66    74   427    37   433   494   381   348   326   478   115   316   411   230   100   186   486   160   197    44    35   367   461   322     3    83   257   104   227   285   315   304   442   296   463   476   404   482   372   380   300   123    73    85     4    51   292   297
   327   443   430   186   244   130   390   272   221   433    27   436    67    25   232    83   421   129    61    19   363   416   301   226   185   160    64   191   106   124   279   163   392     8    53   179    56   407   279    30   349   255   248   431    79    27     7   266   147   437   416   320   360   328   352   171     7    12   134   476   438    34   277   358   412   156   312   397    30   102   201   393   453   346   232    29   484   123   169    66   258   485   152   294   420   477   108   174    15   497    57   233   301   185   176    36   244   389   172   179
    87   183   377    37    28   161   260   197   449   271    81   487   166    71    59     1   394   304   253   167   131     4    62   150   132    79   169   223     3   240   130   297   460   454   331   256    40   225   112   393   112   305   337   293   486    21   174   119   172   183   165   169   469   172   471   494   492   493    13   396   113   453   277   482   178   332    65   271   316   286   489    44   344   363   418   272   362   134    39   330   488    25   417   374    18    20    11     5   341   149   355   402   355   322   368   324   370   285   257   192
   337   439    74   264   243   204    52    44   187   306   464   287   254   109    80    82   281    98   366    22    11   432   217    37   243   302    78   234   388   290     5   281   274   307   423    28   172   499   453   335   325   367    45   133   199   261   347   382    62   153   312   195   309    63   296   295    73   295   440     2    90    46   256    66    15   369   403   190   458   322     2   186   473    29   359   409   254   296   376   132   363    71   439   392   113   410   214   461   120   463     6   125   124   453   402    63   396   308   407   108
    83    46   142   199   497   402   440   246   485   297   219    30    58   147   129   344   444   349   472   287    20   392    69   122   478   306   199    48   352    13   280   100   100    92   467   373    83   348   340    64   103   401   451     4   345   213    59   444    10   230    22    29   499   101   344   116   148   389   495    18   129   293    64   140    67   436   451     4   111    61   215   250    71   493   487   391    23   381   482    63   305   123   305   395   388    59   116   386    98   491   102   453   229   130   346   335   207   410   152   253
   210   375   169   389   482   100   446    51   273   137   463   445   464   497   200   293   479   269    93   403    48   182   245   219   150   358   475   499   255     3   485    10   426   318    56   452    76   407   160    20   466    16   312   145   174   375    71    81   386   364   449   206   441   430   427    16    48   398    27   263   381    36    54    92   493   288   360   340   382   382     1    37    76   198   415   399   133   278   481   231   349   205   246   393   365   116   433   409   473     4   240   315    18   332    15   170   292   226   117   151
    10   210   415    88   177    10   341   200   485   247   490   122   374   423   392   331     6   149   319   113     8     1   132   342   279   452   304   184   150   138   224   408     4   254    13   255   122   279   215     2   352   486   242   293   132    28   441    68   341    34    71   171   102   338   188   328   231   254   486     3   178   409   398    15    29    55   324   381   247   402   467   414   376   279   178    90   458   478   359    14   397    74   420   402   108   160   486    34   196   473   230   427   440   165   293    15   378   316   394   464
   101   354   193   464   179    34   146   332   278   112    55   167   232   145     5   299   248   148   140   329   478     2   222   283   238   265    92     3   221   249   219    25   299   379    15   370    88   214   226    64   415   435   449   427   457    13    93   109   404   288   352   443   101    96    41     6    53   195   263   217    93     2   220   174   121   160   277   115   490   322   342    22   393   149   122   476    99    78   404   149   397   187   123   188   272   485   291    59   179   140    99   431   357   366    35   406     2   125   465     6
   420   473   184   400   455   378   459   399   455   455   443   174   429   350   329   451   264   404   265   407   338     3   420   341   140   147   499   356    76   402   275   481   468   425   307   102    29   180   284   262   276    75   325   295   268   131   415   145   186   420   370   277     6   357   189   298   258     1     2     7   155   201   152   277   442   173   370   178   199   306   271   460     6   435   232   100   349   247   221   228   118   226   427   347   296   440    92    40   412    28   139   450   384   460    50   100   405   281   173   330
   359   450   372   461   445   364   116   219    55    80   247   481   152   200    84   114    56   312   282   484   155    96   249     5   317   133   390   133   144   232   173   160    60   344   458   315   308   294    68   384   195    50   481   236    73    53   385   116   160   422   349   394     5   248    15   428   131   474    47    50    27    38    15   358   338   223   362    23   148    58   198   133   368   470   225   139   100   313    98   491   466   145   166   397   493   176   395    43    85    30    90   180   419    51   491    54   318   239     4   164
   138   277   484   359   200   100    32   175   361   303    34   308   288   111   462   109   404   235   315   259   367   389   332   105    76   328    51   234   270    50    74     6   328    13   252     1   385   446    95   406   433   253   201    37   102    36   409   157    16   260    10   477   337    88   487    26   190    45   203   470    70   296    55    92   289     4   179   168   301    19   295   406   205    25   245   197   186    80   159   199   208   301    54   231   231   264   146   319    96   105   372   324   123    35   276   303   157   496   496   364
   203     8   365   393   136   149   430   329     3   267   410   402   408   119   468    54   363   269   415   230   429   200     5   480   409   352   362   406     1   451   310   128   278    47   484   194   171   445   362   128     3    79   437    67   139   432    12   182    32   429   269   385   282     1   281   381   189   216    20   156    83   205   260    12   121   214   171    93   367   258   260   457   368    45   172   452   225   397    86   159   436   496   444   241   321     9   374     8   206   352   342   367   171   469   245    12   363   326   353   319
    30    97   402   197   276   323   318   385    43   247    62   107   270   265    74    55   221   470   400    11   322   356   201   315    63   186   345   420   317   344   139   376    81   345   341   327    92   409     3   301    77    53    95   308     2    14   424    60   209   278   362   145   437   301   338   374     1    65   195   120     9   146   462   374   347   316   170   454   308   470    87   214   385   372   433   488   142   128   445    76   121   323   492   335   142   287   317    22   428   425   409   499   453   474   398   409   106   338   294   493
   474   155   167   231   211    11    24   368   107   407   454   138    33   227   207   413   425   384   140    10   209   160   136   405   348   445   176     3   224   417   145    42   155    91    60   263   162     3   167   139   200   250    15   127   459   171   361   111   263   224   150    58   487   191     1    32   116   361   432    19   450   219   392   123   271   307   401   477     2   276    13    61   466   144   425    79   466   287   427   202   223   243    69   351   335   129   448   233   263   137   258   261   287    81   208   307   274   127   415   409
   431    86   104    40   449   213   456   470    37    34   191   378   351     9   302   187   205   357   448     9   359     8   474   319   378   126   284   284   104   116    99    29   479   100   144   204   457   167   475    12    55    62    16   380   480   191     7   223   159    62   258   475     8   269   466   491   153    86   242   278   328   163   383   464    12   262    97    35   262   442   427   295   456    68    75    92    34   336   388   326   153   354   424   468   444   435   403   131   355   443   121   430   402   273   431   333   271   359    12   225
   395   248   116   148   426   225     5   379   306   271   270   460   168   267   426   105   333     5    92   183   380   449   165   489    90   445   476   351   217   352   266   494   152   397   268     4   149   312   109   239   312   315   246   279   190   474   122    91   440   116   445   246   369     1   214    82   399   136    54   376   414   269   183   395   253   191   479   346   367   271    66   463    78   161   453   444   200   218   407   275    90   420   239   332   455   402    39   393   118     2   287   359     3    24   272    16   366     6   424   183
   416   302   394    52   103    44    36   238   211    81   389   297   348    76   237   283    47   162   487   367   197   250   367     2   444   452   271   455   309    48   342   260   133   287   395   166   181   152   118   415   245   416   143     1    28   188   250   382   392   141   149   362   312   435   498    49   299   191   305   306   210     3    81   262    53   434    86   148   465   357   433   260   350   281    52    98   365    34     2   312   332   482   221    83   379    50   107   436   244   128   174   272   292   324   238   239   411   124   221   265
   190   331   375   411   432   194   456   184   313   101   404   335   193   277    27   427   332   190    13   150   149   396   183   372    40   329   198   463   442   317    85    89   220   446    82   130   190   226   141   214   277   242     3     6   131   327   171    55   494   201   338   434    83   279   480   257   118   387   412   335   498   222   461   375    15   258    13     6   193    11    17   380   320   213   441   358    98   183   159   449   166   341   368   365   129   194   148   445   466   190   125   285   372     7    70   448    66     3   199   354
   147   267   364   246   183   334   465   293    39   463   367   441   386   458   430   459   190   466   114   111   381   273    60   328   135    11   226    52   496   117   269   128    66   401   347   162   272    97    29   231   133   490    56   404   437   239   484   270   439   249   454   101   118   116   355   482   482   183   193    82   274   339   445    94   207   475    73   331   123   149   131     5   289   416   296   471   112   113    50   128   150   478   113   327    29   164   427   181    20   142   109   460     2   122   110   143   477   411   480   271
