    30    15    64    77    75     8    81    15    88    25    67    18    78    35    83     7    72    89    80    80    16    72    65    38    88    79    20    82    63    44    39    84    34    87    10     6    24    53    14     6    10    39    44    34    47     5    86    68    13    10    27    63    25    26    36     1    39    23    15    54    18    62    20    33    75    80    10    37    18    62    56    64    42    85    50    80    16    51    87     1     9     3    27    64    71    70    17     1    20    12    44    85    86    21     1    57    72    86    57    68    63    55    24    22    63    35    70    51     9     8    24    51    14    63    26    18    75     2    41    21    86    50    31    17    89    18    28     5    54    18    10    86    25    16    61    18     5    84    82    25    50    67    56    36    63    15    55    82     9    62    53    30    37    61    12    85    26    11    69     2     6    18    35     9    85    72     9    11    50    81    86     3    16     1    42    68    27    62    13    86    78    38     9    34     1    10    69     1    74    80    20    40    18     1    28    28    80    41    76    11    40     4    62    46     4     5    71    85    56    89     1     1    35    18    44    48    48    62     2    83    49    20    77    88    33    26    23    27    21    70    85    15     8    89     8    43    57     3     9    50    27    23     5    59    38    52     6    29    46    11     2    69    76    25    64    83    25    12    60     2    27    78    40    47    78    81    65    17    79     1     4     6    61    20    26    47    51    11    10    79    25    38    35    77    60    45    23    53    26    12    66    82    68    88    84    12    51    87    40    13    43    70    25    16    51     4    18     6    10    68    56    60     1    86    17    69    31    11    88    58    24    54    84    27    57    22    26    63    15    54    30    76    28    71    71    84    39    69    88    80    74    10    31    78    77    20    71    72    80    69     7    23    81    17    15    63    52    88     5    79    37    18    16    21    41    81    32    77    83    41    75    72    56    23     9    49    35    62    88    77    51    60     9    60    46    37    57    48    69    73    43    64    81    27     1     2     8    45    29    40    61    49    15    13     1    87    77    73    50     1    14    41    72    62    29    89    54     1    31    40     7    41    35    70    55    76    87    61    15    14    61     8    60     1    79    82     2    62    16    52    75    19     2    61    61    44    38    26    46    28    33    49    82     9    29    60     1    86    43    16    34    77    32    71     4    36    11    65    13    66    58     3    64    47     1    19     9    71     1    84     2    61    72    12    72    30    64    51    41    17    77    81    32     7    24    85    73    70    46    40
    58    37    24    71    32    67    50    44    38    30    87    20     8    70    64    26    51    86    36    76    63    18    18    40    21    80     5     1    16     9    31    68    12    49    65    55    67    24    54    48    70    83     6    48    19    80    55    82    10    83    51    30     2    89    19    48    87    36    83    76    63    52    19    19    66    86    72    60    54    48    42     1     7    16    56    16    50    72    46    32    63     8    66    68    53    32    70    80    75    44    59    29     2    39    19    88    46    27    13    16    54    64    59    80    69    85     9    85     9    89    42    63    14    45    48    39    52     1     9    63    35    87    13    47    63     1     1    88    60    76    59    27    66    57     2    71    57    10    45    48    28    81     1     1    53    13    69    26     2    73    80    56    17    28    17    19    12     3    73    43    62    83    77    56    73     3    45    56    53    56    36    44    46    26     6    50    76    31    18    34    82    67     6    85    21    12    73    22     7    14    28    16    82    69     2    79     2    65    46    21    22    80     1    80    67    37    85    44    12    79    60    66    13    77    15     1    76    76    87    38     6     2     4    14    78     8    34    71    88    71     8    24    68     4    36     9    62    47    84    67    58    68    12    74    86     6    53    48    20     9     9    32    56    16    16    71    74    88    52    45    41    51     1    34    18    64    32    86    33    61    30    62    87    68    54    66    28    68     3    48    35     1    53    11     7     6    73    83     6    13    37    14    66    35     4    29    83    74    44    81    58    71    35    79     1    24    33    36    14    50    14    39    46    86    28    73    18    41    35    49    40    62    37    16    51    36    54    75    56    44     9    43    54    70    41    59    79    65    41    82    53    20    47    72    83    78    26     7    85    73    57    70    72    85    17    21    86     1    18     1    67    43    67    51    68    56    58    64    54     3    22     1    22    59     6     4    13     2    49    49    15    30    54     3     1    52    28    65     9    40    89     1    52    21    89    76    53    27    65    33    40    60    86    30     7    30    49    54    83    83    88    71    67    31    21    42    55    66    56    58     2    43    71     2    80     6    39    70    12    67    56    45    35     2    82    75    81    84    25    10    23    39    87    53    79    53     2    14    40    64    20    59    85    59    50    57    28    13    57     1    78    69    63     8    89    25    35    27    52    62    47    19    81    32    58    40    21     7    15    32    47    64    51    44    23    28    43    43    89    64    14     3    26    52    14     6     7    10    74    43
    58     1    36    74    79    37     1    54    77    74    65    71    33    15    70     9    43    31    24    18    23     1    26     8    70    61    77     6    49    36    59    42    39    87     1    38    77    44    48    14     4    88    73    70    78    22    72    53    12    67    73    62     4    76    21    13    41    70    84    42    15    59     9    50    75     1    65     8    23    26    48    29    11    57    74    87     3    20    41    66    65     1    77    35    75     1    36    45    54    23     1    66    40    61    86     1    33    50    73    80    28    81    63    81    11    54    65    48    34    33    73    82    19    27     1    55    22    24    81     8    50    40    55    61    29    73    23    46    70     1    50    24     1    45     8    51     9     2    87    71    32    46    35    29    10    22    30    32    73    50    80    27    50    38    65    21     5     1    23    74    62    63     1    44    45    87    14    74    44    43    78    25    77    52    12     1    14    23    25     5     5     5    77    34     1    79     2    45    47    12    32    68    26    61     5    70    78     6    77    25    74    12    48    26    57    30    69    65    64    18    50    56    59    60     1    78    63    34    50    89    30    59    68     8     1    41    34    53     2    45    39    34    24    87     3    54    85     1    28    55    78    32    15    37     6    73    36     1    50    71    46    14    64     2     2    47    74     5    21     9    28    10    38    78    56    58    30    15    71    68    16    26     5    44    66    83    18    72    46    64    36    84    46    77    70    74    82    46    81    67    66    63    62    50     8    50    41    32    31     9     5    16    81    17    87    82    40    65    22    86    71     6    30    64    15     1    12     2    28    56    46    71    78    59    87    13    89    86    27    75    80    39    53    72    43    15    75    19    57    68    85    28     1     9    19    87    67    19    31     6     1    78     2    35    37    44    89    85    63    23    10    41    61    31    41    77    66    49    54    79    30    52    33    29    84    58    31    52    44    42     6     2     2    43    43    68    65    74    70    56    58    22    31    71    63    39    32    83    57    47    44    21    16    84    85    87    65    39    70    22    23     1    76    57     9     3     1    88    31    25    14    72    70    75    69    47    26    31    20    61     1    33    89    36    26    62    68    31    73    31    44    51    59    74    47    87     3    29    30    42    55    45    81    32     1     1    36    15     5    55     3    25    47     1    22    85    73    89    82    53    30    45    63     1    57    78    10    61    31    17    15    38     2    27    34    36    68    45    67    76    74    63    39    84    30    15    13     4    38     8
    15    18     5    34    32    63    17    59    67    34    72    67     6    83    35    74     5    32    49    77    29     6    58    35    46    26    57    82    35    59    69    33    80    50     7    56    48    20    44    18    14     9    11    72    87    30    19    60    30    41    48    34    12    26    47    49    10     1    13     4     1    53    10    76    71    44    39    59    54    26    84    34    45    25    72     2    30    59     2    27    23    86    58    26     1     1    64    71    11    40    36    33    27    50    56    66    23    42    11     7    14    47    33    59    30    16    62    35    40     1    75    83     1    39    57    79    43    44    62    57    23    39    25    15    53     4    67    16    82    53    14    39    81    68    62    80    59     2    61    14    46    66    58    23     7    15    16    34    40    38    73    40    20    40     1    25    70    11    54    38    20    74    13    49    55    78     9    43    60    80    17     1    52    76    55     1    87    82     1    23     3     2     2    58    31    16    76    30    21    19    10    10    31    72    37    89    32    51    50    36    29    63    65    60    30    79    26    78    84    18    78    15    31    17    54    50    84     7    60    86    88     1    67    46    88     9     1    21    88    35    11    69     2    47    35    74    71    39    21    60    20    16     1    89    81     1    26    39    49    39    83    83    86    31    67    67    32    21    62     2    59    28    56    46    11    49    30     2    48    20    81     1    57    88    55    34    51    58    84     2    88    61    15     3     8     3    38    68    61    70    69    57    65    26    67    38    75    22    77    79    49    85    87    64    65    17    25    17    24    14    23    32     7    72    80    28    59    26    13    80    87    71    21    29     4    33    58    61    75    22    88    66    67    33    60    65     3    48    25    23     3    87    51    34     2    52    57    26     1    10     4    80    61    32    77    84    26    25    76    34    64    17    73    22    72    77    89    51    63    64    81    67    58    66    85     1    66     6    71    12    58    73    73    80    66     1    19    11    51    22    60     1    46    83    52    35    34     1    88    63    45     2    81    43    38    10    46    84    68     2    43    13     1    67    79    13    46    52    47    78    69    27    31    57    22    65     1    72    47    72    82     4    33     3     9    71    79     1    85    57    27    72    74     7    32    39    55    66    73    23     1    53    32    52    55    36     3    59     8    50    40    76    86    25    13     5     3    40    88    57    88     7    88     1    23    45    44    51    68    54    33     9    13    38    53     9    68    18    46     1    30    35    53    53    18    13    31    73    44     8
    60    75    85    26    79    85    27    48    13    33    30    65    47    72    41    44    43    82    38    33    36    68     2    60     9    82     4    83     8    71    66    52    33    82    19     7    55    81    73    83    83    79    81    66    51    31    24    79    45    77     5    69    19    63    40    82    14    59    37    77    14    81    74    82    50    47    76    34    17    72    69    83    65    47    25    20     4    73     1    20     2    61    37    68    77     1    28    49    39    75    24    10     6    61    72    59    43    25    62    24    54    26    80     2    14    89    31    40    42    64     1     9    69    13    40    89    52    72    75    21     1    49    26    48    50    86     7    23    49    84    27    11    55    76    16    72    76    55    10    62     5    18    47    29    31     5    29    49    89    32     1    17    81    51    30     5    60    47    25    41    58    49    36    23    66    13    45    88     8    58     2    10    24    53    22    72    35    48    82    78    47    23    30    43    62    74    65    87    68    26    20    48    11    33    47    79    27    75    40    44    56    66    27    81    35    49    10    18    55     1    87    21    11    64    34    20    53    34     1    63    53    53     5    86    13    46    21    86    53     1    65    32    79     1    77    34     1     1     3    14    16    27    81    49     8    36    39    61    46    27    70    80    12    49    22    17     2    79    48    37    66    31    55    85    72    66    72    13    34    32    85    59    82    35     1    22    58    55    49    26     1    48     2    23    33    82    11     1    85     1    83    52     5    78    25    74    64    41    76    53    73    18    14    84    45    62    84    20    53    44    51    20    67    39    76     9    23    41    36    23    65    21    40    27    12    40    43    86    79    76    12    20    70    62    63    58    20    53    60     5    73    79    23    29    38    16    80    76    82     7    42    32    21    74    47     3    83     5    24    25     1    25    46    19    22    81    47    82    22    69    51     1    81    82    14    22    72     9    37    19    11    18    55    25    71    73    49    85    55    50    22    74    73    31    74    86    19    59    73    48    86    76    68    35    72    75    42     4    61    21    89    30    83    20    82    46    23    15    76    50    56    89    59    40    36    82    35     2    67    11     1     7    73    14    16    63    42    66    51    38    15     9    31    57    78     1    19    29    80    11    17     3    26    74    66    54     1    82    12    24    27    87    88    13    11    42    66    65    22    73    10    11    66    75    80    20    76     1    62    50    48    47    35    88     4    44     7    61    57     1    75    20    27    12     6    29    53    44    32    47
