   271   669   784   697   646   143   790   566   305   214    93   418   123   228   350   168   675   160   377   144    81   634   178   769   643   561   561    84   125   670   769   798   480   228    52   451   564    87   332   233    53   755   448   143   240   699     4   664   160   714   356    37   505   317   434   439   295   187    72   509   242   345   410   682   225   241   700   705   545   461   222   535   238   607   455   385   453    91    13   277   217   509   135   257   350   661   684   711   723   469   329   373   741   499   315   459   413   616   722    79   544    10   450   644   486    63   495   141   540    19   666   545   415   732     2   303    37   116   572    88    17   640   370   287   652   274   568   388   170   590   297   649   277   689   212     6   479   791   235   568   221   557   780   586   222    24   295   363   138   756    19   496    20   234   542   138   303   341   365    75   472   476   726   534   489   764   187   782    51   476   549   642   420   345   283   199   252   512    21   300   159   439   621   246   401   408   780   431   785   772    33   674   646   342    19   668   220   303   705   535   180   661   405   281   408    86   719   633   188   121    38   513    76   194   477   449   171   535   596   609   745   314   480   314   167    30   312   617   501   397   246   571   764   700   536   626   426   165   253   292
   517   284   341    77   457   567   188   150   109   599   626   172    95    19   773   560   592   484    63   449   563   475   674    19   412   483   620    81   128   463   318   564   534   589   514   251   477    20   153   114   552   656   474   415   682   737   192    70   730    18   203   603   106   118   683    60   694   790   611   557   521   765   184   506   658   369   160   298   777   257   316    70    56   588   738   515     5   133   412   167   363   456   505   487   707   475   741   761   647   771   596   608   480   198   117   137     7    82   468   476   360    65   741   599   490    19   714   109   318   722   212   706   361   760   252   697   797   464   727   190   419   206   793   233    66   157   109   637    28   495    24   390    67   278   312   715    63   676    80   255   394   551   759   320   704   677   504   747   609   258   308   569   719   734   566     5   166   385   764    51   248   304   135   719   273   109   561   569   237    90   475   121   455    52   556   489   653   725    13   638   208   636   744   273   456   276   123   757   740     3   320   613    67   611   402     8   798   591   648   754   249   625   157   273   616   481   426   200    70   277   734   150   373   582    37    15   781   116   756   388   521   427   506   408   493     3    83   476   787    35   392   708   490   138   761   516   388    25   213    84
   523   710   689   298   391   208   625   436   354   693    43   698   108    40   372   133   674   207    98    31   581   667   482   361   297   256   103   306   169   198   447   261   628    13    86   287    90   651   446    49   558   408   397   691   127    44    11   426   236   700   666   512   577   525   563   274    12    19   214   761   702    54   444   573   659   250   499   635    48   163   321   629   725   554   372    47   775   197   270   106   412   777   243   471   672   763   174   278    24   796    92   373   482   296   282    58   390   623   276   287   395   763   628   678     5   127   621   179   795   605   399   426   275   727   328    31   198   734   560    91   137   306   596   352   124    14   174   592    64   327    11   609   631    75   507   694   333   629   648   378   385   538   713   283   544   215   260   212   615   226   732   123   784    96   780   399   179   560   104   561   461   307   607    23   405   744   250   152     6   309   106   135    79   509   797   626   700   340   331    54    17   278   311   397    69   520   648   621   770   755   437   774   505    66   266   167   300   529    79   308   159   422   620    93   174   774   533   564   249   411    21     3   211   553   312   259   228   645   242   686    56    48    27   521   603    84   585   135   691   227   639   133    54   279   294    43    34   525   296   778
   140   292   604    59    45   258   416   316   719   434   130   780   267   113    95     1   631   486   405   267   210     6    99   240   211   127   270   357     5   384   208   476   736   727   530   410    65   361   180   629   179   489   540   468   778    34   279   191   276   292   264   270   751   276   753   790   787   789    21   633   181   726   443   771   285   532   105   435   506   458   783    71   550   580   670   436   579   215    62   528   782    40   667   598    29    32    18     9   546   239   568   644   568   515   589   518   593   457   411   307   407   340   610    11   412   613   198   422   298   710   244   292   655   288    30   361   124   785   789   399   297   478   410   471   284   733   441   101    41   337    30   472   329   323   188   490   665   262   484   250   475   127   497   309   612   138   750    94   516   330   194   626   741   781    67   181    86   418   298   388   733   184    69    22    57   554   209   229   586   366   492   252   543   265   583   517   410   342   207   654    96   798   416    61   795   636   155   757   728   226   788   359   391   455   437   332   745   420   385    10   565   455    56   470   352    40   573   437   128   548    98   695   573   183   747   576   472   576   135   400   267   650   304   240   774   426    24   386    54   275   299   729   529    36    24   350   376     8   395   538
   540   703   119   423   389   326    84    71   300   491   742   459   406   174   129   132   449   158   585    36    18   691   347    59   389   484   126   375   621   464     8   450   439   492   677    44   275   799   724   536   521   587    73   213   319   418   556   611    99   246   499   312   495   101   474   472   117   472   705     4   144    73   409   106    25   591   646   304   734   515     4   298   757    47   574   655   407   474   602   212   581   113   703   627   181   656   342   737   192   741     9   200   199   725   643   101   634   493   651   173   765   647   546   740   204   504   328   601   650   377   141   695   715   231     5   240    99   202   594   681   433    42   511   244   472     1   634    54   378   254   107   794    91   228   303   149   272   700   671   597   414   204   190   740   610   367   136   296   110   376   746   448   225   598    66   744   568   375   325    10   709   494   505   762   409   495   101   792   226   160   487   225   163   374   384   405   392   181   111   726   754   789     9   698   759   624   471   427   497   524    78    58   280   643   664   343   175   415   395   470   452    41   105   247   592   620   135   367   638   720   469   788   139   349   466   401   681    19   697   628   385   629   197    43   357   611   269   536     5   410   261   621   101   113   656   415   384   527   750   709
   133    75   227   319   795   644   704   394   777   475   350    49    94   236   207   551   711   559   756   460    33   627   111   195   764   490   319    78   563    21   449   160   160   148   748   598   133   556   544   102   166   642   721     7   552   340    94   711    17   368    36    47   799   161   551   186   238   622   792    29   207   468   102   224   108   697   723     7   178    98   344   401   114   789   780   626    38   610   771   102   488   198   488   633   621    95   185   618   156   786   163   725   366   208   554   536   331   657   243   405   438   773    12   557     1   368   676   133     5   552   170   398   255    80   766   692   321   589   426   635   543   269   152    67   627   305    98   697   144   301   292    39   659   434   117   402   744   546   567   735   643     3   146   478   153   448   756   618     5   750   470   451   659   325    20     9   685   277   417   247   364   324   144    44   240    16   134   518   200   299   328    28   697    15   564   478   452    10   251   781   402   586   238   553    86    69    24   249    33   517   355   438    20   199   658    87    96   400   330   406     7    17   513   412   389   634    84   153   491   626   425   430   782   114   396   646    65   192   204   345   533   230   213   777   531   493   393   488   501   665   390   569   468   224   363   547   694   753    41   126
   336   600   271   622   771   160   714    82   437   219   742   712   743   796   320   469   767   431   149   645    76   292   393   351   240   573   761   799   408     5   776    16   681   510    90   724   122   652   256    32   745    26   500   233   279   601   114   130   617   583   719   329   705   689   683    26    77   637    43   421   610    57    87   147   790   462   576   544   612   611     1    59   122   318   664   638   214   445   770   370   559   328   394   629   584   186   693   655   758     6   385   505    29   532    24   272   467   362   188   241   534   272   740   277   592   382    53   603    22   752   353   474   577   526   119   621   226   553   290    70   570   257   577   462    89   382    52     3   724   401   269    38   441   726   548   541   718   145   782   201    67   201    22    16   143   402   788   570   701   254   686   697   247   338   100   670   161   760   310   357    12   189   280   710    11   724   117   572   449   789   212   439   756   455   706   546   317   583   598   495   402   575   552    54   467   595   657   620   243   143     3   767     8   628   437    88   711   285   644   789   786   244   281    97   277    88   449    25   664    99   210   567   718   425   104   426   563   771   674   575   559   573   449   725    35   578   484   528   250   478   306   524   154   747   364   359   699   677   293   339
    16   336   665   141   284    16   546   320   777   396   785   195   599   678   628   530     9   238   511   182    13     1   212   548   447   723   487   295   240   221   359   653     7   406    21   409   195   447   344     4   564   778   388   470   211    45   706   109   546    54   114   274   164   541   302   526   370   407   777     5   285   654   637    25    47    89   519   611   396   643   748   663   602   446   286   144   733   766   575    23   636   119   673   643   174   256   778    54   314   756   369   684   704   265   469    24   605   506   631   742   188   777   196   508   783   643   423   547   323   284   453   779   382   287   141   228   760   477     3   548   338   323   683   752    40   253   400   324   697   641     2   245   158    42   764   277    15   287   425   464   740   242   421   305    84   631   708    44   214    19   690   551   412   577    93    20   662   321    87   409   343   649   576   192   532   580   745    14   654   316   110   711   162   728   778   785   616   708   155    92   187   776   269   550   341   332   169   745    80   282    58   762   410   525   118   393   502   607   558   764   607   401   621   340   432   210   380   428   217   299   704   395   587   684   754   355   185   314   568   201    10    50   703   366    85   198    62   721   156   612   269   773   772   101   109   471   208   705   614   246
   162   566   309   742   287    55   234   532   446   179    88   268   371   233     8   479   398   237   224   527   765     4   355   453   381   425   147     5   353   398   350    41   478   606    24   593   141   342   362   103   664   697   718   683   732    21   150   175   647   461   564   708   161   154    65    10    85   312   422   348   149     4   352   278   193   256   443   184   785   516   547    35   629   238   196   762   158   126   647   239   636   300   196   301   435   777   465    94   287   224   159   690   571   586    56   650     3   201   745    10    19    90    23   602   467   248   579   647    35    15   643   348   213   464   528   680    52   514     7   456    84    86     1   476   656   359   525   279   365   417   744   595    37   196   443   462   542    97   279   670   779   551   549   432   656   618   155   268   130   434   505   645   203   334   545   484   799   337   571   126   416   645   404   190   699   618    67   534   336   211   756   523   332   760   231   512   229   516   741   424   147   288   386   537   646   700   514   244   591   335   418   132   769    32   345   739   530    47   667   690   588    22   748   300   755   624   289   148   723   629   707   761   350   467   766   170    60   550   492   701   697   114   489   258   205    51   345   513     1   580   421    32   718   643   341   572   381    47   432   191
   672   757   294   641   729   605   734   639   729   728   708   279   687   560   527   722   422   647   424   651   542     5   672   546   225   235   798   570   122   643   440   770   749   680   491   164    47   288   455   419   442   120   520   472   428   210   665   232   298   672   592   444    10   572   303   476   414     2     3    12   248   322   244   443   707   278   592   285   319   490   435   736    10   697   372   160   559   396   354   365   189   362   683   555   473   705   148    65   660    44   223   721   615   736    81   160   649   449   277   529   683   667   189   179   135   795   729    99   127   594    86    17   100   665   730   781   381   652   666     5   419   397    15   113   392   417   700   114   157   455   198    19   304   556     4   796   662   172   151    49   330   341   294   252   761   289   523   217   138    70   256   530   593    30    60   105   178   669    53   376   343   534   688   519   794     8   110   378   564   294   452   319   617    29   722   725   617   617    25   706   409   605   415   721   266   462    22   721   382   612   301   652   731   370   238   399   567    23   163   785   495   746    14   228   288   657   209   112   611   135   170   150   581   598    98   125   462   704    35   424   727     7   400   661    81    80   573   328   247   281   655   336   598   243   540     3   210    33   755   485
   574   721   596   737   713   583   186   351    89   128   395   769   243   320   135   182    90   499   452   775   248   154   398     8   507   213   625   213   231   372   278   256    96   550   733   505   492   471   109   615   313    80   770   378   116    84   616   186   256   676   559   631     9   397    25   685   209   758    76    81    44    61    24   574   541   357   579    38   237    94   316   212   590   753   361   223   160   502   157   786   746   232   267   635   789   281   633    69   136    49   145   288   670    83   786    86   509   383     7   263   136   685   132   259   275   313   779   551   704   148    22   346   293   261   388   286    99   518    13     7   645   570   692   217   415   257   573   416    73   433   569   599    27   121   631   198   665   786   330   604   105   457   114    69   285   371   333     4   111   242   228   572    97    58   581   481   521   147   602    27   407   789   688   775   491    11   313    91   460   729   539   671   485   182    39   237   111   472   363   736     4   671   378   485   116    83   244   134   718   501   470   234   596   106   242   792   230   112    88   559   667    92   507   266   250   727   735   188   621   126   450   477   661   244   611    47    87   266   338   592   159    46   181    42   589   460   257    85   374   122   777    83   664   317    16   696   642   594   596   367
   221   444   775   574   320   160    52   280   578   484    54   492   461   177   739   175   647   377   504   415   587   623   531   169   123   526    81   374   432    81   118     9   524    21   404     2   616   713   153   650   692   406   321    59   163    59   655   252    25   417    16   763   540   140   779    42   304    72   324   753   112   473    88   147   463     7   286   269   482    31   472   650   329    41   392   316   298   128   254   318   333   481    87   371   370   423   234   511   154   168   595   518   197    56   442   485   252   794   793   582   766   439   783   187   500   631   352   504   733   226   775    23   186   448   507   568   312   425   519   133   459   386   133   127   664   627   654   603   105   699   119   355   393   746   787   454   269   533   320   482   359   234     5   793   512   743   626   323   412   689   259   542   384   584   791   562    22   650   138   658   484   681   541    56   497   749   396   733   735   336   631   735   546   588   370   494   439   668   537    10   693    13   495   711   258    27   340    16   584   575   314   390   235   315   397   416   243   625   229   123   228   237   120   515   438    59   376   574   751   406   260   714   234   635   731   432    94   633   569   563   658   582    32     8   195   146   703   659   686   502   256   595   159   188    10   453   176   382   110    83
   325    13   584   629   219   238   689   527     5   428   657   643   654   191   749    87   581   430   664   368   687   320     9   768   654   563   580   649     1   721   497   205   445    76   774   311   274   712   580   205     5   126   699   108   222   692    20   291    51   686   431   616   452     1   449   609   303   346    32   249   133   328   416    19   194   343   274   149   587   413   416   731   590    72   275   724   360   635   137   255   698   794   711   385   514    15   599    12   330   563   548   587   274   751   393    19   580   522   566   510   145   582   212    87   280   627   233     4   233   649   532    30   494     3    49   423   654   274   511   282    22   611   664   274   339   378   737   206   281   445   272   236   630   109   487   170   423   333   239    82   785   763   201   582    87   558   184   448   307    89   374   368   604   616   358   214    86   609   476   520   799   327   403   791   130   205   273   568     3   423    60    56   767   722   248   642   302   137   518   732   192   525   146   753    65   234   553   632   336   529    36   590   599   342   732   373   253   601   175   609   287   290   307   726   295   141   110   620   610   738   364   190   445   485   478   165    75   412   175   503   635   760     1   548   348   230    16    45   204   419   262   423   683   535   769   699    90   786   687   398
    48   156   644   316   441   517   510   616    69   396    99   172   432   425   119    89   354   752   640    18   515   569   322   505   101   298   552   672   508   551   223   603   130   552   545   523   147   655     5   481   123    85   153   494     4    23   678    96   335   446   580   232   699   481   541   599     1   105   313   192    15   235   740   598   556   506   272   726   493   753   140   343   616   595   693   780   227   205   712   122   194   517   788   536   227   459   508    36   685   680   654   799   725   758   637   654   169   541   470   789   722   409   391   707   423   281     6   731    85   757   659   496     6   493    74   765    27   787   212   610   118   612   272   163   398   611     1   168   186   492   137    35   697    10   493   684   536   295   529    44   586    15   465    17   664   357    80   435    63   148   145   227   453   514    73   591   288   632   455   389   687   189   682    12   296   776   754   490   705   304   421    79   645   430   577   361   579     4   180   106   456   573   646   491     6   125   638    18   130   487   527   757   391   704   582   355   616   694    20   581   490   447   353    69    73   126   231   284    39   610   221   304    63   337   112   308   716   686   312   458    59    76   655   294   318    88   100   465    26   405   201   154   190   479   148   479   733   503   511   642
   759   248   268   370   338    18    39   589   171   651   727   221    53   363   331   661   680   615   224    16   335   256   217   648   558   712   282     5   359   668   233    67   248   146    96   421   260     4   268   223   320   400    25   203   734   274   577   178   422   358   240    92   779   305     1    52   187   578   691    30   720   351   628   198   433   491   641   764     3   442    21    98   745   230   680   127   746   460   684   324   357   390   111   562   536   207   717   373   421   220   414   417   459   129   333   491   438   203   664   655   612   376   794   733   677   531   314     9   147   455   282   175   151   590   115   786   588    96   716   557   319    64   673    57   290   264   702   288   734   413   756   164   796   491    27   276    45   441   798   548   140   500   498   512     8   313   525   468   342    97    20   326   683   614   518   224    86    24   573   293   737   137   283   130   383   477   208    53   657   101   456   608   475   559   533   506    70    18   335   317   300   777   270   447   714   531   619   411   320   504   397   662   555   559   258   497   183   482   149   499   307   611     1   170   654   601   226   191   245   795   771   381   560   285   334   550    18   788   171    49   161   612   606   485   520   502   754   333   688   527   599   354   269   300   273   605   490   681   300   731
   690   138   167    65   718   341   730   752    59    54   306   604   562    15   484   300   329   571   717    15   575    12   758   510   605   202   455   455   167   187   158    46   766   160   230   327   732   267   761    19    88   100    26   608   768   305    11   357   255   100   412   761    13   431   745   786   244   138   387   444   525   261   614   743    19   419   156    57   420   707   684   472   730   109   120   148    54   538   621   522   245   567   678   749   711   697   645   210   568   709   194   688   643   437   690   533   435   575    20   361   116   650   370   799   357   626   544    74   731   463   544   238   438   539   149   633   586    33   171   749   111   456   726   763   360     3   687   274   789   398   177   360   424   597   696   142   669   615   198   475   322   782   196   154   752   570   180   383   129   535   247   242   511    43   534   464   303   420   604   436   167   112   711   462   139   202    25   438   683   497   108   184   440   294   533   659   451   790   635   121   494   630   292   388    14   248   532   487   149   350   675   557   744   346   408   602   654   760    84   346   310   197   254   598    11   795   729   408   482   644   402   612   790   471   206   295    58   455   623   180    10   479   132   711   340   310   696   168   280   420   218   794   447   530   503   417   517    62   706   448
   632   398   185   237   682   361     8   606   490   434   433   736   269   428   681   169   533     8   148   293   608   719   265   783   144   712   761   562   348   564   426   790   244   636   429     7   239   500   174   383   500   504   394   447   304   759   195   145   704   186   712   393   590     1   342   131   638   218    86   602   662   431   293   633   405   306   767   554   588   435   105   742   125   259   726   711   320   349   652   440   144   672   382   531   728   643    63   629   190     3   460   574     5    39   435    26   586    10   678   294   274   481   631   376   516    25   623   405   669    97   477   128   529   512    12    76   242   173   356   291   393   390    30    57   385   423     8   695     2   570   153   794    12   323   391    61   404   287   737   375   285   278     6    18   636    31   400   514   543   759   232    13   315   624    70   128   487     4   503   241   730   406   183   564    61   601   221   209    31   136   281   138   327   692   135   746   487   347   395   418   467   279   200   715   728   722   601   471   366   178   645   321   401   144   237   548   564   442     8   455   155   476   723   119   385    50   117   470     9   512   349   792   740   336   395   299   643   531   515   252   140   479   481   535   277   493   331   487   230    29   511   139   466   140   294   562   595   400   632   781
   666   484   631    84   165    71    59   381   337   129   623   475   557   122   379   453    76   260   779   588   315   400   588     3   711   724   433   729   494    76   548   417   213   459   633   266   289   244   189   664   392   665   230     1    44   302   400   612   627   226   238   579   500   696   797    79   479   306   488   490   337     5   129   420    85   695   138   237   744   571   692   416   561   450    83   157   584    54     4   499   531   772   354   133   606    81   172   697   391   206   279   436   467   519   381   383   658   199   354   425   752   348    17    28   222   669   278   300   554   280   666   261   407    13   490     5   799   402   699   152   242   405   565   139    71   657   623   585   184   279   208    54    70   604   379    76    86   132   776   650   502   535   547    86   468   736   256   511     5   563   373   162   444   713   708   195   271   392    12   395    73    19   622    45     8   615   150   796   669   403   615   666   548   676    89   362   765   518   278   212   733   340   421   486   441   712   351   401    56   514   489   700   722     2   200   766    33   619   514    79   536    72    43   379   148    56   353    58   256   112   112     2   187   540   615    12   290   568   657   478   481   484   330   319   777   333   266   692   359   714   617   597   417   783    62   734   379   605    17   115
   305   529   601   658   692   311   730   295   501   161   647   536   310   444    44   684   531   304    21   240   238   634   293   595    64   526   317   741   708   508   137   142   353   715   131   208   304   361   226   342   443   388     5    10   210   524   274    89   791   322   541   695   133   446   769   411   189   619   660   537   797   355   738   600    24   414    21     9   309    18    27   608   513   341   706   573   157   293   254   719   266   546   589   584   207   310   237   713   746   304   201   456   596    12   112   716   106     5   318   566   387   754   122   120   699   511   648    41   631   508    68   588   479   328   451   226   359    63   401   481   338   163   317   118    72    12   214   272   271   562   198    57   161   525   499   154     2     1   633   664   324   111   102   446   214   577   598   453   604   793   131   258   208   570   764   433   755    39    40   608   572    50   340   168   327   764   140   712   290    15   194     6   328   349   316   482   685   272   233   136   680   758   571    59   620   742   173   609   706   249   228   782   544   165    59   635   386   744   496    36   198   115   405   317   198   511   793    61   602   154   486   723    48   692   606   231   477   355   482   702   590   488   563    23   385   667   277    11   381   109   467   163   374   625   710   704   271   284   441    80
   236   427   583   394   294   535   744   468    63   742   587   706   618   733   689   735   305   746   183   178   609   437    96   525   217    17   362    83   794   188   430   204   106   641   556   260   436   155    46   370   213   784    90   647   700   383   774   432   702   398   726   162   189   186   568   772   771   292   309   131   438   543   712   151   332   760   116   530   197   239   210     8   463   666   474   754   179   181    81   206   240   765   181   523    46   262   683   290    32   228   175   736     3   195   176   228   764   658   769   433   319    35   275   414   446   359    26    64   565   345   509   260    29   482   221   117   585   105   186   453   785   544   184   260   421   234   295   692   674   479   338   682    37   140   248   401    49   518   711   464   613   721    28   668    15   557   607   196   697   767    27   704    74    11   179    37   755   654   349    91    11   461   225   220   304   104   403   181   702   620   657   342   591   624   504   404   340   204   218   656   574   117     4   337   173   263   513   448   629   300   527   677   374   632   331   754   445    44   348   454   655    51   691   439   301   478    18   697   267   600     1   152   130    45   207   495   567   157    15    23   443   361   175   206   674    15   557   440   457   367   605    39   487    23   349   251    49   158   276    99
