    67   167   196   174   161    35   197   141    76    53    23   104    30    57    87    42   168    40    94    36    20   158    44   192   160   140   140    21    31   167   192   199   120    57    13   112   141    21    83    58    13   188   112    35    60   174     1   166    40   178    89     9   126    79   108   109    73    46    18   127    60    86   102   170    56    60   175   176   136   115    55   133    59   151   113    96   113    22     3    69    54   127    33    64    87   165   171   177   180   117
   129    71    85    19   114   141    47    37    27   149   156    43    23     4   193   140   148   121    15   112   140   118   168     4   103   120   155    20    32   115    79   141   133   147   128    62   119     5    38    28   138   164   118   103   170   184    48    17   182     4    50   150    26    29   170    15   173   197   152   139   130   191    46   126   164    92    40    74   194    64    79    17    14   147   184   128     1    33   103    41    90   114   126   121   176   118   185   190   161   192
   130   177   172    74    97    52   156   109    88   173    10   174    27    10    93    33   168    51    24     7   145   166   120    90    74    64    25    76    42    49   111    65   157     3    21    71    22   162   111    12   139   102    99   172    31    11     2   106    59   175   166   128   144   131   140    68     3     4    53   190   175    13   111   143   164    62   124   158    12    40    80   157   181   138    93    11   193    49    67    26   103   194    60   117   168   190    43    69     6   199
    35    73   151    14    11    64   104    79   179   108    32   195    66    28    23     1   157   121   101    66    52     1    24    60    52    31    67    89     1    96    52   119   184   181   132   102    16    90    45   157    44   122   135   117   194     8    69    47    69    73    66    67   187    69   188   197   196   197     5   158    45   181   110   192    71   133    26   108   126   114   195    17   137   145   167   109   144    53    15   132   195    10   166   149     7     8     4     2   136    59
   135   175    29   105    97    81    21    17    75   122   185   114   101    43    32    33   112    39   146     9     4   172    86    14    97   121    31    93   155   116     2   112   109   123   169    11    68   199   181   134   130   146    18    53    79   104   139   152    24    61   124    78   123    25   118   118    29   118   176     1    36    18   102    26     6   147   161    76   183   128     1    74   189    11   143   163   101   118   150    53   145    28   175   156    45   164    85   184    48   185
    33    18    56    79   198   161   176    98   194   118    87    12    23    59    51   137   177   139   189   115     8   156    27    48   191   122    79    19   140     5   112    40    40    37   187   149    33   139   136    25    41   160   180     1   138    85    23   177     4    92     9    11   199    40   137    46    59   155   198     7    51   117    25    56    27   174   180     1    44    24    86   100    28   197   195   156     9   152   192    25   122    49   122   158   155    23    46   154    39   196
    84   150    67   155   192    40   178    20   109    54   185   178   185   199    80   117   191   107    37   161    19    73    98    87    60   143   190   199   102     1   194     4   170   127    22   181    30   163    64     8   186     6   125    58    69   150    28    32   154   145   179    82   176   172   170     6    19   159    10   105   152    14    21    36   197   115   144   136   153   152     1    14    30    79   166   159    53   111   192    92   139    82    98   157   146    46   173   163   189     1
     4    84   166    35    71     4   136    80   194    99   196    48   149   169   157   132     2    59   127    45     3     1    53   137   111   180   121    73    60    55    89   163     1   101     5   102    48   111    86     1   141   194    97   117    52    11   176    27   136    13    28    68    41   135    75   131    92   101   194     1    71   163   159     6    11    22   129   152    99   160   187   165   150   111    71    36   183   191   143     5   159    29   168   160    43    64   194    13    78   189
    40   141    77   185    71    13    58   133   111    44    22    67    92    58     2   119    99    59    56   131   191     1    88   113    95   106    36     1    88    99    87    10   119   151     6   148    35    85    90    25   166   174   179   170   183     5    37    43   161   115   141   177    40    38    16     2    21    78   105    87    37     1    88    69    48    64   110    46   196   129   136     8   157    59    49   190    39    31   161    59   159    75    49    75   108   194   116    23    71    56
   168   189    73   160   182   151   183   159   182   182   177    69   171   140   131   180   105   161   106   162   135     1   168   136    56    58   199   142    30   160   110   192   187   170   122    41    11    72   113   104   110    30   130   118   107    52   166    58    74   168   148   111     2   143    75   119   103     1     1     3    62    80    61   110   176    69   148    71    79   122   108   184     2   174    93    40   139    99    88    91    47    90   170   138   118   176    37    16   165    11
   143   180   149   184   178   145    46    87    22    32    98   192    60    80    33    45    22   124   113   193    62    38    99     2   126    53   156    53    57    93    69    64    24   137   183   126   123   117    27   153    78    20   192    94    29    21   154    46    64   169   139   157     2    99     6   171    52   189    19    20    11    15     6   143   135    89   144     9    59    23    79    53   147   188    90    55    40   125    39   196   186    58    66   158   197    70   158    17    34    12
    55   111   193   143    80    40    13    70   144   121    13   123   115    44   184    43   161    94   126   103   146   155   132    42    30   131    20    93   108    20    29     2   131     5   101     1   154   178    38   162   173   101    80    14    40    14   163    63     6   104     4   190   135    35   194    10    76    18    81   188    28   118    22    36   115     1    71    67   120     7   118   162    82    10    98    79    74    32    63    79    83   120    21    92    92   105    58   127    38    42
    81     3   146   157    54    59   172   131     1   107   164   160   163    47   187    21   145   107   166    92   171    80     2   192   163   140   145   162     1   180   124    51   111    19   193    77    68   178   145    51     1    31   174    27    55   173     5    72    12   171   107   154   113     1   112   152    75    86     8    62    33    82   104     4    48    85    68    37   146   103   104   182   147    18    68   181    90   158    34    63   174   198   177    96   128     3   149     3    82   140
    12    39   161    79   110   129   127   154    17    99    24    43   108   106    29    22    88   188   160     4   128   142    80   126    25    74   138   168   127   137    55   150    32   138   136   130    36   163     1   120    30    21    38   123     1     5   169    24    83   111   145    58   174   120   135   149     1    26    78    48     3    58   185   149   139   126    68   181   123   188    35    85   154   148   173   195    56    51   178    30    48   129   197   134    56   114   127     9   171   170
   189    62    67    92    84     4     9   147    42   162   181    55    13    90    82   165   170   153    56     4    83    64    54   162   139   178    70     1    89   167    58    16    62    36    24   105    65     1    67    55    80   100     6    50   183    68   144    44   105    89    60    23   194    76     1    13    46   144   172     7   180    87   157    49   108   122   160   191     1   110     5    24   186    57   170    31   186   115   171    81    89    97    27   140   134    51   179    93   105    55
   172    34    41    16   179    85   182   188    14    13    76   151   140     3   121    75    82   142   179     3   143     3   189   127   151    50   113   113    41    46    39    11   191    40    57    81   183    66   190     4    22    25     6   152   192    76     2    89    63    25   103   190     3   107   186   196    61    34    96   111   131    65   153   185     4   104    39    14   105   176   171   118   182    27    30    37    13   134   155   130    61   141   169   187   177   174   161    52   142   177
   158    99    46    59   170    90     2   151   122   108   108   184    67   107   170    42   133     2    37    73   152   179    66   195    36   178   190   140    87   141   106   197    61   159   107     1    59   125    43    95   125   126    98   111    76   189    48    36   176    46   178    98   147     1    85    32   159    54    21   150   165   107    73   158   101    76   191   138   147   108    26   185    31    64   181   177    80    87   163   110    36   168    95   132   182   160    15   157    47     1
   166   121   157    21    41    17    14    95    84    32   155   118   139    30    94   113    19    65   194   147    78   100   147     1   177   181   108   182   123    19   137   104    53   114   158    66    72    61    47   166    98   166    57     1    11    75   100   153   156    56    59   144   125   174   199    19   119    76   122   122    84     1    32   105    21   173    34    59   186   142   173   104   140   112    20    39   146    13     1   124   132   193    88    33   151    20    43   174    97    51
    76   132   150   164   173    77   182    73   125    40   161   134    77   111    11   171   132    76     5    60    59   158    73   148    16   131    79   185   177   127    34    35    88   178    32    52    76    90    56    85   110    97     1     2    52   131    68    22   197    80   135   173    33   111   192   102    47   154   165   134   199    88   184   150     6   103     5     2    77     4     6   152   128    85   176   143    39    73    63   179    66   136   147   146    51    77    59   178   186    76
    59   106   145    98    73   133   186   117    15   185   146   176   154   183   172   183    76   186    45    44   152   109    24   131    54     4    90    20   198    47   107    51    26   160   139    65   109    38    11    92    53   196    22   161   175    95   193   108   175    99   181    40    47    46   142   193   192    73    77    32   109   135   178    37    83   190    29   132    49    59    52     2   115   166   118   188    44    45    20    51    60   191    45   130    11    65   170    72     8    57
