   169   359   418   450   490   372   435   461   404   445    89   364   494   116   353   219   190    55   134    80    58   247   261   481    77   152   143   200   218    84   105   114   421    56   100   312   236   282    90   484    51   155   396    96   111   249   480     5   402   317   351   133   351   390    53   133    78   144   419   232   481   173   498   160   300    60   142   344    32   458   282   315   353   308    54   294   207    68   145   384    33   195   472    50   280   481    89   236   150    73   437    53     2   385   415   116   100   160   446   422   223   349    23   394   315     5   198   248   271    15   274   428   184   131   117   474    45    47   318    50   151    27   216    38   256    15   426   358   140   338   150   223   437   362   440    23   340   148   288    58   139   198   334   133   149   368   379   470   284   225   241   139   283   100    57   313     8    98   173   491   136   466   318   145    84   166   161   397   218   493   413   176   427   395   444    43   452    85   293    30   206    90   233   180   463   419   311    51   197   491   287    54   258   318   385   239   451     4    49   164   340    85     6   428   281    82   402   162   303   172    39   196   309   487    88   344   337   440    12    93   416    13   340   216   259   183   458   163     1   242   189   179    23    62    72   324   357     8    55     4
   323   138   178   277   213   484    48   359   285   200   354   100   117    32    93   175    68   361   374   303   391    34   108   308    59   288    12   111   483   462   350   109   370   404   302   235    39   315   281   259   351   367   296   389   421   332    12   105   258    76   301   328   387    51    50   234    80   270   289    50   199    74   352     6   334   328   368    13   321   252   157     1   298   385    12   446    96    95    71   406   345   433   410   253   296   201   259    37   426   102   461    36   120   409    43   157   456    16    11   260   127    10   377   477    66   337    74    88   427   487    37    26   433   190   494    45   381   203   348   470   326    70   478   296   115    55   316    92   411   289   230     4   100   179   186   168   486   301   160    19   197   295    44   406    35   205   367    25   461   245   322   197     3   186    83    80   257   159   104   199   227   208   285   301   315    54   304   231   442   231   296   264   463   146   476   319   404    96   482   105   372   372   380   324   300   123   123    35    73   276    85   303     4   157    51   496   292   496   297   364   225   478    41   274   463   489   374   117   306   312    11   394   446   220    68   315   198   458   451   141   132   484   441    14   225   116   475   280   157   317   435   355   498   195   290   265   454   324   118    83
   327   203   443     8   430   365   186   393   244   136   130   149   390   430   272   329   221     3   433   267    27   410   436   402    67   408    25   119   232   468    83    54   421   363   129   269    61   415    19   230   363   429   416   200   301     5   226   480   185   409   160   352    64   362   191   406   106     1   124   451   279   310   163   128   392   278     8    47    53   484   179   194    56   171   407   445   279   362    30   128   349     3   255    79   248   437   431    67    79   139    27   432     7    12   266   182   147    32   437   429   416   269   320   385   360   282   328     1   352   281   171   381     7   189    12   216   134    20   476   156   438    83    34   205   277   260   358    12   412   121   156   214   312   171   397    93    30   367   102   258   201   260   393   457   453   368   346    45   232   172    29   452   484   225   123   397   169    86    66   159   258   436   485   496   152   444   294   241   420   321   477     9   108   374   174     8    15   206   497   352    57   342   233   367   301   171   185   469   176   245    36    12   244   363   389   326   172   353   179   319   247    91   477   364   392   132   423    54     3   175    79   392   388   146   112     2   496   146   378   405   249   332   266    19   172   309   454     2   205    30    19   264   123   409   459   171   350   319    57   176
    87    30   183    97   377   402    37   197    28   276   161   323   260   318   197   385   449    43   271   247    81    62   487   107   166   270    71   265    59    74     1    55   394   221   304   470   253   400   167    11   131   322     4   356    62   201   150   315   132    63    79   186   169   345   223   420     3   317   240   344   130   139   297   376   460    81   454   345   331   341   256   327    40    92   225   409   112     3   393   301   112    77   305    53   337    95   293   308   486     2    21    14   174   424   119    60   172   209   183   278   165   362   169   145   469   437   172   301   471   338   494   374   492     1   493    65    13   195   396   120   113     9   453   146   277   462   482   374   178   347   332   316    65   170   271   454   316   308   286   470   489    87    44   214   344   385   363   372   418   433   272   488   362   142   134   128    39   445   330    76   488   121    25   323   417   492   374   335    18   142    20   287    11   317     5    22   341   428   149   425   355   409   402   499   355   453   322   474   368   398   324   409   370   106   285   338   257   294   192   493   254   451   212   256   381   244     7   442   257   264   383   176   123     4   264   456   186    53   444   473   152   412   182   310   409     4   180   308    18    46   225   478    77    17   491   492   493   132   249   381
   337   474   439   155    74   167   264   231   243   211   204    11    52    24    44   368   187   107   306   407   464   454   287   138   254    33   109   227    80   207    82   413   281   425    98   384   366   140    22    10    11   209   432   160   217   136    37   405   243   348   302   445    78   176   234     3   388   224   290   417     5   145   281    42   274   155   307    91   423    60    28   263   172   162   499     3   453   167   335   139   325   200   367   250    45    15   133   127   199   459   261   171   347   361   382   111    62   263   153   224   312   150   195    58   309   487    63   191   296     1   295    32    73   116   295   361   440   432     2    19    90   450    46   219   256   392    66   123    15   271   369   307   403   401   190   477   458     2   322   276     2    13   186    61   473   466    29   144   359   425   409    79   254   466   296   287   376   427   132   202   363   223    71   243   439    69   392   351   113   335   410   129   214   448   461   233   120   263   463   137     6   258   125   261   124   287   453    81   402   208    63   307   396   274   308   127   407   415   108   409   478   383   404   235   341   496   462   458   128   423   315   332   205   196   376     5   406    92   235   284    88   176   434   109   446    94   144   369     3    71   150   491    62   367   126    60   371   447   426   348
    83   431    46    86   142   104   199    40   497   449   402   213   440   456   246   470   485    37   297    34   219   191    30   378    58   351   147     9   129   302   344   187   444   205   349   357   472   448   287     9    20   359   392     8    69   474   122   319   478   378   306   126   199   284    48   284   352   104    13   116   280    99   100    29   100   479    92   100   467   144   373   204    83   457   348   167   340   475    64    12   103    55   401    62   451    16     4   380   345   480   213   191    59     7   444   223    10   159   230    62    22   258    29   475   499     8   101   269   344   466   116   491   148   153   389    86   495   242    18   278   129   328   293   163    64   383   140   464    67    12   436   262   451    97     4    35   111   262    61   442   215   427   250   295    71   456   493    68   487    75   391    92    23    34   381   336   482   388    63   326   305   153   123   354   305   424   395   468   388   444    59   435   116   403   386   131    98   355   491   443   102   121   453   430   229   402   130   273   346   431   335   333   207   271   410   359   152    12   253   225   274    72   483   406     7   231   348   499     1   223   230   391   422   340    83    46     3   457   345   289   106   340   249   148   159   274    50   337   479    93   433   395   201   366   368    20   266   107   397   468
   210   395   375   248   169   116   389   148   482   426   100   225   446     5    51   379   273   306   137   271   463   270   445   460   464   168   497   267   200   426   293   105   479   333   269     5    93    92   403   183    48   380   182   449   245   165   219   489   150    90   358   445   475   476   499   351   255   217     3   352   485   266    10   494   426   152   318   397    56   268   452     4    76   149   407   312   160   109    20   239   466   312    16   315   312   246   145   279   174   190   375   474    71   122    81    91   386   440   364   116   449   445   206   246   441   369   430     1   427   214    16    82    48   399   398   136    27    54   263   376   381   414    36   269    54   183    92   395   493   253   288   191   360   479   340   346   382   367   382   271     1    66    37   463    76    78   198   161   415   453   399   444   133   200   278   218   481   407   231   275   349    90   205   420   246   239   393   332   365   455   116   402   433    39   409   393   473   118     4     2   240   287   315   359    18     3   332    24    15   272   170    16   292   366   226     6   117   424   151   183   333   171   170   300   462   394   173   235   370   322   239    15    33   389   377   253    14   418   470    61   220   298   296    80   360   330   329   320    74     7   388    48   141   151   346   108   181   222    44   182
    10   416   210   302   415   394    88    52   177   103    10    44   341    36   200   238   485   211   247    81   490   389   122   297   374   348   423    76   392   237   331   283     6    47   149   162   319   487   113   367     8   197     1   250   132   367   342     2   279   444   452   452   304   271   184   455   150   309   138    48   224   342   408   260     4   133   254   287    13   395   255   166   122   181   279   152   215   118     2   415   352   245   486   416   242   143   293     1   132    28    28   188   441   250    68   382   341   392    34   141    71   149   171   362   102   312   338   435   188   498   328    49   231   299   254   191   486   305     3   306   178   210   409     3   398    81    15   262    29    53    55   434   324    86   381   148   247   465   402   357   467   433   414   260   376   350   279   281   178    52    90    98   458   365   478    34   359     2    14   312   397   332    74   482   420   221   402    83   108   379   160    50   486   107    34   436   196   244   473   128   230   174   427   272   440   292   165   324   293   238    15   239   378   411   316   124   394   221   464   265   117   470   486   217   122    10   317    17   489   139   402   418   264   174   341   187   202   346   177   175   283   416   487   163   238   254   179     8    88   306   142     3   475   499   298   251     2   437   342    95
   101   190   354   331   193   375   464   411   179   432    34   194   146   456   332   184   278   313   112   101    55   404   167   335   232   193   145   277     5    27   299   427   248   332   148   190   140    13   329   150   478   149     2   396   222   183   283   372   238    40   265   329    92   198     3   463   221   442   249   317   219    85    25    89   299   220   379   446    15    82   370   130    88   190   214   226   226   141    64   214   415   277   435   242   449     3   427     6   457   131    13   327    93   171   109    55   404   494   288   201   352   338   443   434   101    83    96   279    41   480     6   257    53   118   195   387   263   412   217   335    93   498     2   222   220   461   174   375   121    15   160   258   277    13   115     6   490   193   322    11   342    17    22   380   393   320   149   213   122   441   476   358    99    98    78   183   404   159   149   449   397   166   187   341   123   368   188   365   272   129   485   194   291   148    59   445   179   466   140   190    99   125   431   285   357   372   366     7    35    70   406   448     2    66   125     3   465   199     6   354    11   242    56   471    14    76   376    75   292   437   155   319   362   405   404    25    21   394     9   318   402    42   217   367   133   299   290   205   330   282   425   141    32   224   321    39     4   251   285   301
   420   147   473   267   184   364   400   246   455   183   378   334   459   465   399   293   455    39   455   463   443   367   174   441   429   386   350   458   329   430   451   459   264   190   404   466   265   114   407   111   338   381     3   273   420    60   341   328   140   135   147    11   499   226   356    52    76   496   402   117   275   269   481   128   468    66   425   401   307   347   102   162    29   272   180    97   284    29   262   231   276   133    75   490   325    56   295   404   268   437   131   239   415   484   145   270   186   439   420   249   370   454   277   101     6   118   357   116   189   355   298   482   258   482     1   183     2   193     7    82   155   274   201   339   152   445   277    94   442   207   173   475   370    73   178   331   199   123   306   149   271   131   460     5     6   289   435   416   232   296   100   471   349   112   247   113   221    50   228   128   118   150   226   478   427   113   347   327   296    29   440   164    92   427    40   181   412    20    28   142   139   109   450   460   384     2   460   122    50   110   100   143   405   477   281   411   173   480   330   271   426   199   417    22   118   171   111   258    84   278   497   224   455    16    62    40    79   353   371   215    53   318    10   162    63    18   416   301   456   138   488    73   238   366   408    65   416   116     3   283
