    33    16    71    86    83     9    90    17    98    28    74    20    87    39    92     8    80    99    89    89    17    80    72    42    98    88    23    91    70    49    43    94    38    97    11     7    26    59    16     6    11    43    49    38    52     6    96    75    15    11    30    70    28    29    40     1    43    25    16    60    21    68    22    37    84    88    11    41    20    69    62    71    47    94    56    89    18    57    96     1    10     4    31    71    79    78    19     1    22    13    49    94    96    24     1    63    80    95    63    75    70    61    26    25    70    39    78    56    10     9    26    56    15    70    28    20    83     2    46    23    96    56    34    19    99    20    32     5    60    20    12    95    28    18    68    20     6    93    91    28    56    74    63    40    70    16    61    91    10    69    58    33    41    68    13    95    29    12    76     2     6    20    39    11    94    80    10    12    56    90    96     3    17     1    47    76    30    69    14    96    87    42    10    38     1    11    77     1    83    88    23    44    20     2    32    31    89    46    84    12
    64    42    27    79    35    75    55    49    42    33    96    23     9    77    71    29    57    96    40    85    70    20    20    45    23    89     6     1    18    10    35    75    13    54    72    61    74    27    60    54    78    92     6    54    21    89    61    92    11    92    57    33     2    99    22    53    96    40    92    85    70    58    21    21    74    95    80    66    60    53    47     1     7    18    63    18    56    80    51    36    70     9    73    76    59    36    77    89    84    49    66    33     2    43    21    97    51    30    15    18    60    71    65    89    77    95    10    95    10    99    46    70    16    51    54    43    57     1    10    70    39    97    14    53    70     2     1    98    66    85    65    30    73    63     2    79    64    11    50    53    31    90     1     1    59    15    77    29     2    81    89    62    19    32    19    21    14     4    81    47    69    93    86    62    82     3    50    63    59    62    40    49    51    29     7    55    85    34    20    38    92    75     7    94    24    14    81    24     8    16    31    18    91    77     3    88     2    72    52    23
    65     2    40    83    88    42     1    60    86    83    73    78    37    17    78    10    48    35    27    20    26     2    29     8    78    68    86     7    54    40    65    47    44    97     1    42    86    49    53    16     5    98    82    77    87    24    80    59    13    74    81    69     5    84    23    15    46    78    93    47    16    66    10    56    84     1    72     9    25    29    53    32    12    63    83    97     3    22    46    73    72     1    85    39    83     1    40    50    60    26     1    73    45    68    96     1    37    55    81    88    32    90    70    90    12    60    72    54    38    36    81    91    21    30     1    61    24    27    90     9    55    44    62    68    32    81    25    52    78     1    55    26     1    50     9    57    10     2    96    79    35    51    38    33    11    24    34    36    81    55    89    30    55    43    72    23     6     1    25    83    69    70     1    49    51    97    15    83    49    48    87    28    86    58    13     1    15    26    27     5     5     5    86    37     1    88     2    50    53    13    36    76    29    68     6    78    87     6    85    28
    17    20     6    38    36    70    19    66    75    38    80    75     7    92    39    82     5    35    55    86    32     6    64    38    52    29    63    91    39    66    77    36    89    55     8    62    54    22    49    20    16    11    12    80    97    33    21    67    33    46    54    38    14    29    53    55    11     1    14     5     1    59    11    85    78    49    44    66    60    29    94    38    50    28    80     2    33    65     2    30    26    95    64    29     1     1    71    79    12    44    40    36    30    56    63    74    26    47    12     8    15    53    37    65    33    18    69    39    44     1    84    92     1    44    63    88    48    49    68    63    26    43    27    17    59     5    75    17    92    59    16    44    90    75    69    89    66     3    68    16    51    74    65    26     8    17    18    38    45    42    81    45    22    45     1    28    78    12    60    42    22    83    15    55    61    87    10    48    67    89    19     1    58    85    61     1    97    91     1    26     4     2     2    65    34    18    84    34    23    21    12    11    34    80    41    98    36    57    55    40
    67    84    94    29    87    94    31    53    14    36    33    72    52    80    46    49    48    91    42    36    40    75     2    66    10    91     4    93     8    79    73    58    37    91    21     7    61    91    81    92    92    88    90    73    57    34    27    88    50    85     6    77    21    70    45    91    16    65    41    86    16    90    82    91    56    52    85    38    19    80    76    93    73    53    28    22     4    81     2    22     2    67    41    76    86     1    32    54    43    84    27    12     7    68    81    65    48    28    69    27    60    29    89     2    15    99    35    45    46    71     1    10    77    15    44    99    58    80    83    23     1    55    29    53    56    96     8    25    54    93    31    13    61    85    18    80    84    61    12    69     5    20    52    32    34     5    32    54    99    36     1    19    90    56    33     5    67    52    27    46    65    55    40    26    73    15    50    98     9    65     3    11    26    59    25    80    39    53    91    87    52    26    34    47    69    83    72    96    76    29    22    54    12    37    52    87    30    84    44    49
