    33    16    71    86    83     9    90    17    98    28    74    20    87    39    92     8    80    99    89    89    17    80    72    42    98    88    23    91    70    49    43    94    38    97    11     7    26    59    16     6    11    43    49    38    52     6    96    75    15    11    30    70    28    29    40     1    43    25    16    60    21    68    22    37    84    88    11    41    20    69    62    71    47    94    56    89    18    57    96     1    10     4    31    71    79    78    19     1    22    13    49    94    96    24     1    63    80    95    63    75    70    61    26    25    70    39    78    56    10     9    26    56    15    70    28    20    83     2    46    23    96    56    34    19    99    20    32     5    60    20    12    95    28    18    68    20     6    93    91    28    56    74    63    40    70    16    61    91    10    69    58    33    41    68    13    95    29    12    76     2     6    20    39    11    94    80    10    12    56    90    96     3    17     1    47    76    30    69    14    96    87    42    10    38     1    11    77     1    83    88    23    44    20     2    32    31    89    46    84    12    44     4    69    51     4     5    78    95    63    99     1     1    39    20    49    53    54    68     3    93    54    23    85    98    36    29    26    30    23    77    94    17     9    99     9    48    63     3    10    55    30    25     5    65    43    58     7    32    51    12     3    76    85    28    71    92    28    13    67     2    30    87    44    52    87    90    72    19    88     1     4     7    68    22    29    52    57    12    11    88    27    43    39    85    66    50    26    59    29    14    73    91    75    98    94    13    56    97    45    15    48    78    27    18    56     4    20     6    11    76    62    67     1    96    19    77    34    12    98    65    27    61    93    30    63    24    29    70    16    61    33    84    32    79    79    93    43    77    98    88    82    11    35    87    85    23    79    80    88    77     8    26    90    19    17    71    58    98     6    88    41    20    18    24    46    90    36    86    92    45    83    80    62    26    10    54    39    69    98    86    57    67    10    66    51    41    63    54    77    82    47    71    90    30     1     2     9    50    32    45    68    54    17    14     1    96    85    81    56     1    16    46    80    69    32    99    60     1    34    44     7    46    39    78    61    84    97    68    17    16    68     9    67     1    88    91     2    69    18    57    83    21     2    68    68    49    43    29    51    31    36    54    91    10    32    67     1    95    48    18    37    86    35    79     4    40    12    73    14    73    64     4    71    53     1    21    11    79     1    93     2    67    80    13    80    33    71    57    46    19    86    90    35     8    27    95    81    78    51    45
    64    42    27    79    35    75    55    49    42    33    96    23     9    77    71    29    57    96    40    85    70    20    20    45    23    89     6     1    18    10    35    75    13    54    72    61    74    27    60    54    78    92     6    54    21    89    61    92    11    92    57    33     2    99    22    53    96    40    92    85    70    58    21    21    74    95    80    66    60    53    47     1     7    18    63    18    56    80    51    36    70     9    73    76    59    36    77    89    84    49    66    33     2    43    21    97    51    30    15    18    60    71    65    89    77    95    10    95    10    99    46    70    16    51    54    43    57     1    10    70    39    97    14    53    70     2     1    98    66    85    65    30    73    63     2    79    64    11    50    53    31    90     1     1    59    15    77    29     2    81    89    62    19    32    19    21    14     4    81    47    69    93    86    62    82     3    50    63    59    62    40    49    51    29     7    55    85    34    20    38    92    75     7    94    24    14    81    24     8    16    31    18    91    77     3    88     2    72    52    23    25    89     2    89    75    41    95    49    13    88    67    73    14    86    17     1    85    85    97    42     7     3     5    16    86     9    38    79    98    79     9    27    76     5    40    10    69    52    94    75    65    76    14    82    95     7    59    53    23    10    11    36    63    18    18    79    82    98    57    50    46    57     1    38    20    72    35    95    37    68    33    69    97    76    60    73    32    76     3    54    39     1    59    13     8     7    81    92     7    15    41    15    73    39     5    32    92    83    49    90    64    79    39    88     1    26    37    40    16    55    16    43    51    96    31    81    20    46    39    55    45    69    41    18    57    41    60    84    63    49    10    47    60    78    46    66    88    73    46    91    59    23    52    80    92    86    29     7    95    81    63    78    80    94    19    23    96     1    21     1    74    48    74    57    76    63    64    71    60     3    24     1    24    66     7     4    14     3    55    54    17    34    60     3     1    58    31    73    10    45    99     1    58    23    99    84    59    30    72    36    45    66    95    34     8    34    54    60    92    92    97    78    74    34    23    47    61    74    62    64     2    47    78     3    89     6    44    77    13    75    63    50    39     2    91    83    90    94    28    12    26    44    96    59    88    59     2    16    45    72    23    66    95    65    56    64    31    14    63     1    87    77    71     9    99    28    39    30    58    69    53    21    90    36    64    44    23     8    16    36    52    71    57    49    25    32    48    48    99    72    16     3    29    57    15     7     8    11    83    48
    65     2    40    83    88    42     1    60    86    83    73    78    37    17    78    10    48    35    27    20    26     2    29     8    78    68    86     7    54    40    65    47    44    97     1    42    86    49    53    16     5    98    82    77    87    24    80    59    13    74    81    69     5    84    23    15    46    78    93    47    16    66    10    56    84     1    72     9    25    29    53    32    12    63    83    97     3    22    46    73    72     1    85    39    83     1    40    50    60    26     1    73    45    68    96     1    37    55    81    88    32    90    70    90    12    60    72    54    38    36    81    91    21    30     1    61    24    27    90     9    55    44    62    68    32    81    25    52    78     1    55    26     1    50     9    57    10     2    96    79    35    51    38    33    11    24    34    36    81    55    89    30    55    43    72    23     6     1    25    83    69    70     1    49    51    97    15    83    49    48    87    28    86    58    13     1    15    26    27     5     5     5    86    37     1    88     2    50    53    13    36    76    29    68     6    78    87     6    85    28    83    14    53    29    64    34    77    72    72    20    56    62    65    67     1    87    70    37    56    99    34    65    76     9     1    46    37    59     2    50    43    38    26    97     4    61    95     1    31    61    87    35    16    42     6    81    41     1    55    79    52    16    71     3     2    52    82     5    24    10    31    11    42    86    62    64    34    17    79    76    18    29     6    49    73    93    20    80    51    71    40    93    52    86    78    82    91    52    90    75    73    70    69    55     9    56    46    35    34    10     5    18    90    19    96    91    45    73    24    95    79     6    33    71    17     1    13     2    31    62    51    79    87    66    97    14    99    96    30    84    88    44    58    80    48    16    84    21    64    75    95    32     1    10    21    97    74    21    34     6     1    87     3    39    41    48    99    94    70    25    11    46    68    34    46    85    73    54    60    88    34    58    37    33    93    64    35    58    49    47     7     3     2    47    48    75    72    82    77    63    65    24    34    78    70    44    35    92    63    53    49    23    18    94    95    97    72    43    78    24    26     2    84    63    10     3     1    97    35    27    15    80    78    83    77    52    29    34    22    68     1    37    99    40    29    69    75    35    81    35    49    56    66    83    53    97     3    32    34    47    61    50    90    35     1     1    41    17     6    61     3    28    52     1    24    95    81    99    91    59    34    50    70     1    63    87    11    68    35    19    17    42     2    30    38    40    76    50    74    85    83    70    44    94    34    17    15     5    42     8
    17    20     6    38    36    70    19    66    75    38    80    75     7    92    39    82     5    35    55    86    32     6    64    38    52    29    63    91    39    66    77    36    89    55     8    62    54    22    49    20    16    11    12    80    97    33    21    67    33    46    54    38    14    29    53    55    11     1    14     5     1    59    11    85    78    49    44    66    60    29    94    38    50    28    80     2    33    65     2    30    26    95    64    29     1     1    71    79    12    44    40    36    30    56    63    74    26    47    12     8    15    53    37    65    33    18    69    39    44     1    84    92     1    44    63    88    48    49    68    63    26    43    27    17    59     5    75    17    92    59    16    44    90    75    69    89    66     3    68    16    51    74    65    26     8    17    18    38    45    42    81    45    22    45     1    28    78    12    60    42    22    83    15    55    61    87    10    48    67    89    19     1    58    85    61     1    97    91     1    26     4     2     2    65    34    18    84    34    23    21    12    11    34    80    41    98    36    57    55    40    33    70    72    67    33    88    29    86    93    20    87    16    34    19    60    55    94     8    67    96    98     1    74    51    98    10     1    23    98    39    13    77     2    52    39    82    79    43    24    67    22    18     1    99    90     1    29    44    55    44    92    92    96    34    74    75    35    24    69     3    66    32    63    51    13    55    34     2    54    23    90     1    63    98    61    38    57    64    94     2    97    68    17     3     8     4    42    76    68    78    77    64    72    29    74    42    83    24    86    88    54    95    97    71    72    19    28    19    26    15    25    36     7    80    89    31    66    29    15    89    97    79    24    33     5    37    64    68    83    24    98    73    74    37    67    73     3    54    28    25     4    97    57    38     2    58    63    29     1    11     4    89    68    35    85    93    29    28    85    38    71    19    81    25    80    86    99    57    71    71    90    74    64    73    94     1    73     7    79    14    64    81    81    89    74     1    21    13    57    25    67     1    51    93    58    39    38     1    98    70    50     2    90    48    42    11    51    94    76     2    48    15     1    75    88    15    51    58    52    87    76    31    35    63    24    72     1    81    52    80    91     5    37     4    10    78    88     1    94    63    30    80    82     8    36    43    62    73    81    26     1    59    36    58    61    41     3    66     9    56    45    85    95    28    15     6     3    44    98    64    98     7    98     1    26    50    49    57    76    60    37    10    14    42    59    10    76    20    51     1    34    39    58    59    20    14    35    82    49     9
    67    84    94    29    87    94    31    53    14    36    33    72    52    80    46    49    48    91    42    36    40    75     2    66    10    91     4    93     8    79    73    58    37    91    21     7    61    91    81    92    92    88    90    73    57    34    27    88    50    85     6    77    21    70    45    91    16    65    41    86    16    90    82    91    56    52    85    38    19    80    76    93    73    53    28    22     4    81     2    22     2    67    41    76    86     1    32    54    43    84    27    12     7    68    81    65    48    28    69    27    60    29    89     2    15    99    35    45    46    71     1    10    77    15    44    99    58    80    83    23     1    55    29    53    56    96     8    25    54    93    31    13    61    85    18    80    84    61    12    69     5    20    52    32    34     5    32    54    99    36     1    19    90    56    33     5    67    52    27    46    65    55    40    26    73    15    50    98     9    65     3    11    26    59    25    80    39    53    91    87    52    26    34    47    69    83    72    96    76    29    22    54    12    37    52    87    30    84    44    49    62    74    30    90    39    55    11    20    61     1    97    23    12    71    38    23    59    37     1    71    59    59     6    96    14    51    23    96    59     1    72    36    88     1    86    38     1     1     3    16    18    31    90    54     9    40    43    67    51    30    78    89    13    55    24    18     3    88    54    41    73    34    61    95    80    74    80    14    38    35    95    66    91    39     1    24    64    61    55    29     1    54     2    26    37    92    12     1    94     1    93    57     5    87    28    83    71    46    85    59    81    20    15    94    50    69    93    22    59    49    57    22    75    44    85    10    26    45    40    25    72    23    44    30    14    45    48    95    87    85    13    22    78    69    70    65    22    59    67     5    82    88    25    32    42    18    89    85    92     8    46    36    24    82    52     4    92     5    27    28     1    27    51    21    25    90    52    92    24    76    57     1    90    92    16    24    80    10    41    22    12    20    61    28    79    81    54    95    61    56    25    82    81    34    83    96    21    66    81    54    95    85    76    39    80    83    47     4    68    23    99    34    92    22    91    51    25    16    84    55    63    99    66    44    41    91    39     3    75    12     1     8    81    15    18    70    47    74    56    43    17    10    35    63    86     2    21    32    89    12    18     3    28    83    73    60     1    91    14    27    30    97    98    14    12    47    73    73    25    81    12    13    74    83    89    23    85     1    69    56    54    52    39    98     5    49     8    68    63     1    84    23    30    14     7    32    59    49    36    52
