   339   901   871   891   988   439   268   494   154   400   210   112   472   968   792   498   804   267   106   289   962   320   285   916   706   589   291   391   560   472   874   770   201   845    46    11   543   856   234    95   303    76   853   676   875    47   576   396   298   941   482   200    17   983   637   333   437   352   889   170   412   360   623   982   516   479    99   170   563   324    79   974   675   186   681   367     3   358   145    16    22   713   359   519   710   520   738   711   346   151     8   832   294   755   696   142   278   464   454   139
   647   555    96   400   235   351   749    68   118   222   700   809    79   518   593   664   516   657   101   540   398    12   737   505   596   892   143   866   592    74   922   819   913   521   754   675   854    52   988   406   652   592   633   579   201   337   321   591    71    51   644   373   515   398   570   109   884   529   952   192   745   648   247   553     9   992   595   957   927   234    23   440   397   283   883   232   315   710   580   649   524   482   292   831   136   754   619   149    84   932   894   336   101   603   689     6   880   928   934   515
   654    16   373   273   781   659   866   821   135   239   167   726   123   460   833    11   371   704   383     2   559   257    16   968   113   890    61     6   496   135    55    25   295   858   641   565   704   762    24    40   877   410   717   243   624   186   204   520   906    90    59   450   338   318   971   889   840    18   348   413   115   734   370   491   488   653   359   182   785   109   159   292   993   811   533   618   410   529   918   638   171   764   440   424   218   257   408   340   789   136   867   529   810   103   672   252   680   698   265   384
   175   195    74   552   520   770   542   124   333   531     1   442   507    22     8   402   264   373   446   635   260   753   909   682    81   818   786   154   675   617    42   848   345   557   338   874   942   749   987   391   227   293   964   695   131   908   572   175   688   744   545   284    78   152    50   985    37   574    11   856   711   999   644   796   741   676   384   903   763   884   766     8   372   946   365     8    37   957   982   265   371   765   589   498   552   211   422   171   412    12   612   670   606    55   159   581   765   446   118    79
   675   310   529   423   105   736   613   908   508   454   165   850   732    20   864   272   486   890   468   448    10    84   615   120   344     6   670   400    91   254   523   722   124   448   390   974   593    65   590   864   180   438   133   542   807   955   644    26   946   288   819   933   753   405   142   139   227   259   922   526    12   522   907   417   792   254   216   766   683   916   630   393   813   569   869   189     6   983   253   895   541    81   306   363   793   361   318   946   114   613   187    56   839   686   255   622   763   391   371   427
   167   172   398   898   880   940   594   382   117    19   689   411   945    19   784   948   956   252    97   208   561    58   185   288   166   334   128   110   902   760   426    14    21   125    59    16   689   983   778   484   259   327   280    24   903    71   122   855   143   136   782    68   964   653   247   848   777   871   773   711   204   860   261   862   414   718   506   145    15   999   460   680     7   579   498   548   958   791   736   214   679   571    84   450   122   343   376   222   824   747   503   836   709   594     4   245   191   713   773   162
   420   497   778   853   893   758   274   541   929   535   586   666   186   366   365   331   300   890   999   435   970   988   637   536   152   625    41   625   625   559   751   244   772   233   412   738   854   164   796   108   763   538   184   506   720   692   764   132   152   323   798   400   962   550   410   478   730   804   819   237   481   718   665   544   584    12   302   343   925   470   478   779    28   122   592   661   149    96   692   445   712   487   578   481    65   869   502   191   551   404   676   505   977   469   251     8   178    39   713   679
    21   605   177   206   682   476   495   778   749   152   663    95   639   735     2   735   559   905   368   618   448   521   508   791   244   305     5   490   485     2    57   500   683   282   343   625   377    99   509   610   356     6    31   107   649   297   804   866   753   563   180   731   719   624   149   443   217   101    68   489   461   545   331   477   757   249   928   941   245    35   804   348   404   350   974   509   176     6   596   874   423   507   941    89   501   731   802   260   198   755   346   108   532   813   303   683   105   920    55     7
   202   662   928   865   293   368   224   809   464   555   599   664   281   300     5   366   476   658     6   885   438   178   758   164   177   452   129   554   898    13    27   343   809   402   886   167    82   514   390   825   187   444   348    31   554    12   645    34   787   427   952   196   808   899   375   736   544   388   118   933   198   570   733   140     4     6    12   484    29   150   311   810    43   636   435   599   660   283   642   502   106   204   595    90   657   341   521   247    47   656   577     3   348   831   688   127   821   721   336   755
   840   534   801   367   918   586   910   734   859   916   903   381   530   222     7   120   281    22   712   992   550   256   850   695    59   194   524   266   650   809   263   968   373   498   555   237   379   965     2   386   310   679   554   415   740   663   613   263    12   832   200   224   443   257   452   226   592   328    81    40   279   920   920   220   811   823   661   399   236   517   994    33   159   431    21    36   913   146   816   233   524   680   141   526   875   866   568   423   380   175   995    61   189   580   426    36   951   696   272   871
   718   980   922   179   232   381   161   522   304   437   228   200   565   102   193   961   634   702   266   838   347   600   688   564   616   415   769   944   963   300   106   830   321   446   789   397    31   369   948   636    55   513   717   301   724   681   117   669   737   568   279   114   197   272   290   322   986   855    87   587   181   926   103   574   636   903   329    12   165   607   392   176   880   833   432   916   485    47   648   110   806   462   272   343   717   212   541   812    34   265   248   988   412   276   572   733   356   369     5   945
   276   426   718   709    65   136   606   216   577   966   218   605   630   703   778    24   153   775   468   579   148   668    27   314   770   192   813   820   402   853    73    87    32   254   954   148   974   867    90   697   140   230   184   461   358   972    39    88   411   922   395   166   318   454   602   608   463   927   639   964   744   600    70   171   315   585   728    82   979   613   789   137   916   265    29   950   634   996   531   237   574   992   159   196   818    35   874   488   491   390   568   845   400   492   293   400   640   630   404   323
   406   861   787   260   861   442   535   873   817   465   109   259   830   726   400   452   818   129   812   248   621   785    95   359   343   558   256   510   874   159   865   533    64   832   770   657   562    15   433   952   166   555    24   312   343    60   516   786   737   465   905   246   172   516   992   589   642   217    16   995   685   603   938    72   726   345   638   954   265     7   784   224   292   499    38   908    61   247   343   114    28   745   343    17   922    81   556   761   788   634   212   786   299   481   954   354   108   325   560   283
    60   755   395   322   637   899   495   975   540   119   111   608   801   263   712   301   126   338   841   481   279   920   690   512   184   225   602   611   191   972    28   239   418   330   290   345   677   984   131   792    18   554   748   665   340   633   941    89   770   837   976   268   890   977   646   748   284    22    45   299   818   710   948   648   212   514   986   425   488   515   352   528   107   305   620   361    92   155   984   498   148   513   204   917     1    52   615   591   871   235   855   327   661   594    19   386   830   938   544   413
   949   149   463   408    49   375   814   574    66   161   827   197   280    23   321    74   697   157     6   580   291   548   182    56   325   906   279   734    31   399   342   764   527   624   116   127     1   147   723     5   900   512   247   739   802   917   552   373   932   718   158   593   855   727   487   784   670   428   466   927   517   248   162   127   548   814   819   809   993   256   664   752   184   177   219   289   143   124   120   852   399   639    71     1   878   472   516   992   995   379   346   875   998   518   625   925    10   170   585   470
   863   284    81   805   913   971    68    61   703   259   375   698   896    41    16   244   756   399   568    26   198   200   200   747   915   680    24   803    33   690   382   889   319    45   951   202   932   297   173    36   656   128   929   872   195   223   884   501   912   975   185   763   776   611   709   791   889   232   263   983   243   458   546   670   543   304   451   966   462     1   782   166   914   212   297   100   186   402    41   794   139   190   954   382   859   180   498    48   530   146   178   682   248   804   977   598   940   946   479   938
   791   339   297   201    10   546   543   890   336   401   211   539   185    96   898   438   180   951   702     6   532   852   795   905   299   320   479    33   493   349   949   163   880   899   492   861   428    97   273   527   828   108   791   577   958   765   543    74   157   830   888   556   815   699   840   786   911   866   787     8   575    37    49   340   733   235   367   340   789   740    31   754   837   441   161   658    15   282   216    88   492   722    72   478    10   906   713    47    15   686    76   182   921    84   348    20   795   985   643   317
   832   831   105    20    73   971   162   244   697   785   566   298   974    16   500   685   889   608   911   276   685     9   574   511   362   431   830   973   287   264   377   136   784   142   724   677   997   463   382     6   421   796   525   111   172   495   714   829   701   357   196   957     5   795   965   804   758   973   872   946   349   880   649    30   822   789   531   972    21   979   836   683   693   566   326   359   612   950   502   685   303   854   174   317   778   871   349   307    87   955    95   359   970   925   669   382   585   886   639    24
   381   386   822    69   913   557   202   335   387    10   855   297    26   957   792   566    80   184   926   498   171   598   893   741   381   452   428   871     6   915   655   219   989   705   869   193   961   107   774   435   996   440   750   321    27   981    23    44   641   245   717   157   318   795   683   376   259   582   891   280   251   714    15   813   132   931   708   113   153   584   639   809   789   804   735   580   564    65    79   570   423     1   147   449   267   457   702   744   201   554   192   122   791   974   139   540   268   194   566   543
   295   368   493   757   931   911   927   349   772   659   919   808   229   677   547   683   271   998   104   804   538   937   802   205   545   569   462   151   113   536   479   290   878   740   203   715   710   517   366    15   548   305   189   347   146   399   299   920   579   465   942   495   101   237   956   694    58   185   362    56   219   769   244   200   955   346   542   834   343   168   449   124   706   107   325   832   276   476   131     7   981    19   325   521   369   197   599    24    46     5   501   215   889   413   902   315    19   653   245    88
   836   745   808   728   707   111   116   962   286   169   843   624   180   310   223    10   702   781   156   465   997   120    65   631   108   137    67   100   179   146     5   232   892   699   631   496   548   262    91   101   432    30   281   446   881   296   278   266   759   451   567   627   347   933   169   794   826   791   904    61   466   838   394   108   770     9   680   857   805   344   619   688    24    27   519   327   379   124   715     9   800   865   815   322   485    91   371   749   862   789   599   983   710   131   975    87    30   417   172   303
   356   968   571   200   187   722   783   616    24   924   740   471   562   734   843   211   603   102   161   101   705   656   642     2    25   191   691   507   519   204   240   315    23    20   133   176    75   380   763   941   957   110   823     9   373   603   395   813   735   490     7   160   209   417   631   463   593   293   809   210   760   246   147   607   103   992   451   549   749   625   892   631   903   969   451   560   871   391   909   167   258   166    83   783   797   131    30   444   348   984    79   666   319   449   949   991   846   783   762   861
   887   731   488   298   545     6    54   804    51   936   842   538    39   859   602   960   320   725   212   902   326   557   107   389   814   725   698   158   863   278    14   364   875   539   721     1   343   379   268   312    68   520   824   429   794   734   402   914   693   344   969   794   133   872   304   482   954   749    30   704   466   343   352    24   778   707   494   728   847   350   776     5   757   665   344     4    39   818   700   353   383   830   155   473   740   351    14   296    93   609   417   417   473   982   891   728   268   230   769   111
   366   805    56   646   395    87   163   215   142   148   789   940   334   644   124   631   159   691     6   689   595   162   663   654   451     7   224   106   586     5   349   120   366   725   939   602   988     1    27   240   907   925   357   633   543   616   978   429   726   866   724   257   661   243   834   670    41   635   683   850   805   906   737   818   571   588   509   512    14   529   247   913   888   824   818   616   451    34   987   763   597   340   355   764   127   232    37    44   404   617   831   369   312   733   622    22   173   100   646   185
   879   335   486    22    89   214   928   276   218   414   562   768    45   419   434   810   605   353   776   835   563   310   847   527   998   335   651   501   267   918   695   222   307   301   619   382   590   233   881    38    92   785    31   614   380     4     5   123    59   851   509   575   265   447   879   703   820   896   240   275   250   574   804   614   616   830   957   471   925   847   411    11   471   352   893   738   300   735   743   697    52   841   590   330    68   918   133   205   286    34   340   552   746   175   237   640   459   656   138   122
    93   208   994   426   493    74   438   756   295   605   889   714   575   719   139   638   613   569   704   233   200   958   935   409   696   951   207   125     9   960   118   446   460   516   998   539   233   306   991   556   586   767   135   524     9   525   431   590   987   150    47   673   127   307   610   937   118   806   196   886   907   804   692   666   821    25   548   812   697   447   845    92   691   680   318   674   866   732   532   937   337   907   784     4   872   986   366   450   542   870   930   769   919   403   182   192   560   225     7   669
   750   232   964   451   103   613   927   920   995   852   959    10   806   760   491   979   716   952   510   705    21   305   113     9   815   218   932   630   291   380   143   182   729   890   882     1    33   798    54   752    72   366   987   382   680   735     1   927   397   907   267   437   463   180   493   664   233    79   947     4   631     6    30    33   453   848   667   601   346   645    67   506   940   596   721   640   776   303   362   364   321    38   112   529     4     2   337   993   908   489   897   359   251   356    27    23   502   500   876   949
   420   789   355    89   400   422   981   594   847   474    12   325   227   394   265     4   904   542   300    96   816   267    26   332   558   236   705   832   587    56   883   765    68   298   205   870   657   599   972   613   818   162    59   869   763   930   935   521   558   104   917    68    29   664   841   167   320   215   393   257   855   584   586   479   633   443   235   435   635   278   528   375   355   832   477    16   285   999     4   190   404   706    50   821   405   230     3    67    53   474    19   165   581   628   526   108   788   320   268   704
   708   751   359   388   665   626   111   670   291    55   497   380   659   298   444   744   531   397   442   635    51   441    30   261   428   283   830   485   854   263   187   111   576   676   202   558    12   236   527   671     5   922   242   517   230   386   684   760   298   882   198   366   299   332   246   730   971   297   358   380   862   745    70   896   251   398    23   943   752   874   724    51    18    85   266   410   850   449     8   602   107   396   820    15   349   338   931    72   246   623   678     1   838   405   686   558   773   748   163   991
   946   729   911   669   799    79   886   882   700   861   528   933   814   762   840   656   294   453   152   235   962   133   614   325   360    58   553   980   590   875   831   541   841   908    12   233   596   964     4   164   402   890   884   950   357   246   543    11   871   593   698   226   457   300   854   654   881   854   825   285   901     4   101   286   562   961   853    44   223   557   911    80   743   636   126   603   977   732   833   566   497   231   490   293   143   843   248   853   696   310   828   647    62   766   368   835   362   759   172   959
