    16     8    35    43    41     4    45     8    49    14    37    10    43    19    46     4    40    49    44    44     8    40    36    21    49    44    11    45    35    24    21    47    19    48     5     3    13    29     8     3     5    21    24    19    26     3    48    37     7     5    15    35    14    14    20     1    21    12     8    30    10    34    11    18    42    44     5    20    10    34    31    35    23    47    28    44     9    28    48     1     5     2    15    35    39    39     9     1    11     6
    32    21    13    39    17    37    27    24    21    16    48    11     4    38    35    14    28    48    20    42    35    10    10    22    11    44     3     1     9     5    17    37     6    27    36    30    37    13    30    27    39    46     3    27    10    44    30    46     5    46    28    16     1    49    11    26    48    20    46    42    35    29    10    10    37    47    40    33    30    26    23     1     3     9    31     9    28    40    25    18    35     4    36    38    29    18    38    44    42    24
    32     1    20    41    44    21     1    30    43    41    36    39    18     8    39     5    24    17    13    10    13     1    14     4    39    34    43     3    27    20    32    23    22    48     1    21    43    24    26     8     2    49    41    38    43    12    40    29     6    37    40    34     2    42    11     7    23    39    46    23     8    33     5    28    42     1    36     4    12    14    26    16     6    31    41    48     1    11    23    36    36     1    42    19    41     1    20    25    30    13
     8    10     3    19    18    35     9    33    37    19    40    37     3    46    19    41     2    17    27    43    16     3    32    19    26    14    31    45    19    33    38    18    44    27     4    31    27    11    24    10     8     5     6    40    48    16    10    33    16    23    27    19     7    14    26    27     5     1     7     2     1    29     5    42    39    24    22    33    30    14    47    19    25    14    40     1    16    32     1    15    13    47    32    14     1     1    35    39     6    22
    33    42    47    14    43    47    15    26     7    18    16    36    26    40    23    24    24    45    21    18    20    37     1    33     5    45     2    46     4    39    36    29    18    45    10     3    30    45    40    46    46    44    45    36    28    17    13    44    25    42     3    38    10    35    22    45     8    32    20    43     8    45    41    45    28    26    42    19     9    40    38    46    36    26    14    11     2    40     1    11     1    33    20    38    43     1    16    27    21    42
