    67   167   196   174   161    35   197   141    76    53    23   104    30    57    87    42   168    40    94    36    20   158    44   192   160   140   140    21    31   167   192   199   120    57    13   112   141    21    83    58    13   188   112    35    60   174     1   166    40   178    89     9   126    79   108   109    73    46    18   127    60    86   102   170    56    60   175   176   136   115    55   133    59   151   113    96   113    22     3    69    54   127    33    64    87   165   171   177   180   117    82    93   185   124    78   114   103   154   180    19   136     2   112   161   121    15   123    35   135     4   166   136   103   183     1    75     9    29   143    22     4   160    92    71   163    68   142    97    42   147    74   162    69   172    53     1   119   197    58   142    55   139   195   146    55     6    73    90    34   189     4   124     5    58   135    34    75    85    91    18   118   119   181   133   122   191    46   195    12   119   137   160   105    86    70    49    63   128     5    75    39   109   155    61   100   102   195   107   196   193     8   168   161    85     4   167    55    75   176   133    45   165   101    70   102    21   179   158    47    30     9   128    19    48   119   112    42   133   149   152   186    78   120    78    41     7    78   154   125    99    61   142   191   175   134   156   106    41    63    73
   129    71    85    19   114   141    47    37    27   149   156    43    23     4   193   140   148   121    15   112   140   118   168     4   103   120   155    20    32   115    79   141   133   147   128    62   119     5    38    28   138   164   118   103   170   184    48    17   182     4    50   150    26    29   170    15   173   197   152   139   130   191    46   126   164    92    40    74   194    64    79    17    14   147   184   128     1    33   103    41    90   114   126   121   176   118   185   190   161   192   149   152   120    49    29    34     1    20   117   119    90    16   185   149   122     4   178    27    79   180    53   176    90   190    63   174   199   116   181    47   104    51   198    58    16    39    27   159     7   123     6    97    16    69    78   178    15   169    20    63    98   137   189    80   176   169   126   186   152    64    77   142   179   183   141     1    41    96   191    12    62    76    33   179    68    27   140   142    59    22   118    30   113    13   139   122   163   181     3   159    52   159   186    68   114    69    30   189   185     1    80   153    16   152   100     2   199   147   162   188    62   156    39    68   154   120   106    50    17    69   183    37    93   145     9     3   195    29   189    97   130   106   126   102   123     1    20   119   196     8    98   177   122    34   190   129    97     6    53    21
   130   177   172    74    97    52   156   109    88   173    10   174    27    10    93    33   168    51    24     7   145   166   120    90    74    64    25    76    42    49   111    65   157     3    21    71    22   162   111    12   139   102    99   172    31    11     2   106    59   175   166   128   144   131   140    68     3     4    53   190   175    13   111   143   164    62   124   158    12    40    80   157   181   138    93    11   193    49    67    26   103   194    60   117   168   190    43    69     6   199    23    93   120    74    70    14    97   155    69    71    98   190   157   169     1    31   155    44   198   151    99   106    68   181    82     7    49   183   140    22    34    76   149    88    31     3    43   148    16    81     2   152   157    18   126   173    83   157   162    94    96   134   178    70   136    53    65    53   153    56   183    30   196    24   195    99    44   140    26   140   115    76   151     5   101   186    62    38     1    77    26    33    19   127   199   156   175    85    82    13     4    69    77    99    17   130   162   155   192   188   109   193   126    16    66    41    75   132    19    77    39   105   155    23    43   193   133   141    62   102     5     1    52   138    78    64    57   161    60   171    14    12     6   130   150    21   146    33   172    56   159    33    13    69    73    10     8   131    74   194
    35    73   151    14    11    64   104    79   179   108    32   195    66    28    23     1   157   121   101    66    52     1    24    60    52    31    67    89     1    96    52   119   184   181   132   102    16    90    45   157    44   122   135   117   194     8    69    47    69    73    66    67   187    69   188   197   196   197     5   158    45   181   110   192    71   133    26   108   126   114   195    17   137   145   167   109   144    53    15   132   195    10   166   149     7     8     4     2   136    59   142   161   142   128   147   129   148   114   102    76   101    85   152     2   103   153    49   105    74   177    61    73   163    72     7    90    31   196   197    99    74   119   102   117    71   183   110    25    10    84     7   118    82    80    47   122   166    65   121    62   118    31   124    77   153    34   187    23   129    82    48   156   185   195    16    45    21   104    74    97   183    46    17     5    14   138    52    57   146    91   123    63   135    66   145   129   102    85    51   163    24   199   104    15   198   159    38   189   182    56   197    89    97   113   109    83   186   105    96     2   141   113    14   117    88    10   143   109    32   137    24   173   143    45   186   144   118   144    33   100    66   162    76    60   193   106     6    96    13    68    74   182   132     9     6    87    94     2    98   134
   135   175    29   105    97    81    21    17    75   122   185   114   101    43    32    33   112    39   146     9     4   172    86    14    97   121    31    93   155   116     2   112   109   123   169    11    68   199   181   134   130   146    18    53    79   104   139   152    24    61   124    78   123    25   118   118    29   118   176     1    36    18   102    26     6   147   161    76   183   128     1    74   189    11   143   163   101   118   150    53   145    28   175   156    45   164    85   184    48   185     2    50    49   181   160    25   158   123   162    43   191   161   136   185    51   126    82   150   162    94    35   173   178    57     1    60    24    50   148   170   108    10   127    61   118     1   158    13    94    63    26   198    22    57    75    37    68   175   167   149   103    51    47   185   152    91    34    74    27    94   186   112    56   149    16   186   142    93    81     2   177   123   126   190   102   123    25   198    56    40   121    56    40    93    96   101    98    45    27   181   188   197     2   174   189   156   117   106   124   131    19    14    70   160   166    85    43   103    98   117   113    10    26    61   148   155    33    91   159   180   117   197    34    87   116   100   170     4   174   157    96   157    49    10    89   152    67   134     1   102    65   155    25    28   164   103    96   131   187   177
    33    18    56    79   198   161   176    98   194   118    87    12    23    59    51   137   177   139   189   115     8   156    27    48   191   122    79    19   140     5   112    40    40    37   187   149    33   139   136    25    41   160   180     1   138    85    23   177     4    92     9    11   199    40   137    46    59   155   198     7    51   117    25    56    27   174   180     1    44    24    86   100    28   197   195   156     9   152   192    25   122    49   122   158   155    23    46   154    39   196    40   181    91    52   138   134    82   164    60   101   109   193     3   139     1    92   169    33     1   138    42    99    63    20   191   173    80   147   106   158   135    67    38    16   156    76    24   174    36    75    73     9   164   108    29   100   186   136   141   183   160     1    36   119    38   112   189   154     1   187   117   112   164    81     5     2   171    69   104    61    91    81    36    11    60     4    33   129    50    74    82     7   174     3   141   119   113     2    62   195   100   146    59   138    21    17     6    62     8   129    88   109     5    49   164    21    24   100    82   101     1     4   128   103    97   158    21    38   122   156   106   107   195    28    99   161    16    48    51    86   133    57    53   194   132   123    98   122   125   166    97   142   117    56    90   136   173   188    10    31
    84   150    67   155   192    40   178    20   109    54   185   178   185   199    80   117   191   107    37   161    19    73    98    87    60   143   190   199   102     1   194     4   170   127    22   181    30   163    64     8   186     6   125    58    69   150    28    32   154   145   179    82   176   172   170     6    19   159    10   105   152    14    21    36   197   115   144   136   153   152     1    14    30    79   166   159    53   111   192    92   139    82    98   157   146    46   173   163   189     1    96   126     7   133     6    68   116    90    47    60   133    68   185    69   148    95    13   150     5   188    88   118   144   131    29   155    56   138    72    17   142    64   144   115    22    95    13     1   181   100    67     9   110   181   137   135   179    36   195    50    16    50     5     4    35   100   197   142   175    63   171   174    61    84    25   167    40   190    77    89     3    47    70   177     2   181    29   143   112   197    53   109   189   113   176   136    79   145   149   123   100   143   138    13   116   148   164   155    60    35     1   191     2   157   109    22   177    71   161   197   196    61    70    24    69    22   112     6   166    24    52   141   179   106    26   106   140   192   168   143   139   143   112   181     8   144   121   132    62   119    76   131    38   186    91    89   174   169    73    84
     4    84   166    35    71     4   136    80   194    99   196    48   149   169   157   132     2    59   127    45     3     1    53   137   111   180   121    73    60    55    89   163     1   101     5   102    48   111    86     1   141   194    97   117    52    11   176    27   136    13    28    68    41   135    75   131    92   101   194     1    71   163   159     6    11    22   129   152    99   160   187   165   150   111    71    36   183   191   143     5   159    29   168   160    43    64   194    13    78   189    92   171   176    66   117     6   151   126   157   185    47   194    49   127   195   160   105   136    80    71   113   194    95    71    35    57   190   119     1   137    84    80   170   188    10    63   100    81   174   160     1    61    39    10   191    69     3    71   106   116   185    60   105    76    21   157   177    11    53     4   172   137   103   144    23     5   165    80    21   102    85   162   144    48   133   145   186     3   163    79    27   177    40   182   194   196   154   177    38    23    46   194    67   137    85    83    42   186    20    70    14   190   102   131    29    98   125   151   139   191   151   100   155    85   108    52    95   107    54    74   176    98   146   171   188    88    46    78   142    50     2    12   175    91    21    49    15   180    39   153    67   193   193    25    27   117    52   176   153    61
    40   141    77   185    71    13    58   133   111    44    22    67    92    58     2   119    99    59    56   131   191     1    88   113    95   106    36     1    88    99    87    10   119   151     6   148    35    85    90    25   166   174   179   170   183     5    37    43   161   115   141   177    40    38    16     2    21    78   105    87    37     1    88    69    48    64   110    46   196   129   136     8   157    59    49   190    39    31   161    59   159    75    49    75   108   194   116    23    71    56    39   172   142   146    14   162     1    50   186     2     4    22     5   150   116    62   144   161     8     3   160    87    53   116   132   170    13   128     1   114    21    21     1   119   164    89   131    69    91   104   186   148     9    49   110   115   135    24    69   167   194   137   137   108   164   154    38    67    32   108   126   161    50    83   136   121   199    84   142    31   104   161   101    47   174   154    16   133    84    52   189   130    83   190    57   128    57   129   185   106    36    72    96   134   161   175   128    61   147    83   104    33   192     8    86   184   132    11   166   172   147     5   187    75   188   156    72    37   180   157   176   190    87   116   191    42    15   137   123   175   174    28   122    64    51    12    86   128     1   145   105     8   179   160    85   143    95    11   108    47
   168   189    73   160   182   151   183   159   182   182   177    69   171   140   131   180   105   161   106   162   135     1   168   136    56    58   199   142    30   160   110   192   187   170   122    41    11    72   113   104   110    30   130   118   107    52   166    58    74   168   148   111     2   143    75   119   103     1     1     3    62    80    61   110   176    69   148    71    79   122   108   184     2   174    93    40   139    99    88    91    47    90   170   138   118   176    37    16   165    11    55   180   153   184    20    40   162   112    69   132   170   166    47    44    33   198   182    24    31   148    21     4    25   166   182   195    95   163   166     1   104    99     3    28    98   104   175    28    39   113    49     4    76   139     1   199   165    43    37    12    82    85    73    63   190    72   130    54    34    17    64   132   148     7    15    26    44   167    13    94    85   133   172   129   198     2    27    94   141    73   113    79   154     7   180   181   154   154     6   176   102   151   103   180    66   115     5   180    95   153    75   163   182    92    59    99   141     5    40   196   123   186     3    57    72   164    52    28   152    33    42    37   145   149    24    31   115   176     8   106   181     1   100   165    20    20   143    82    61    70   163    84   149    60   135     1    52     8   188   121
   143   180   149   184   178   145    46    87    22    32    98   192    60    80    33    45    22   124   113   193    62    38    99     2   126    53   156    53    57    93    69    64    24   137   183   126   123   117    27   153    78    20   192    94    29    21   154    46    64   169   139   157     2    99     6   171    52   189    19    20    11    15     6   143   135    89   144     9    59    23    79    53   147   188    90    55    40   125    39   196   186    58    66   158   197    70   158    17    34    12    36    72   167    20   196    21   127    95     1    65    34   171    33    64    68    78   194   137   176    37     5    86    73    65    97    71    24   129     3     1   161   142   173    54   103    64   143   104    18   108   142   149     6    30   157    49   166   196    82   151    26   114    28    17    71    92    83     1    27    60    57   143    24    14   145   120   130    36   150     6   101   197   172   193   122     2    78    22   115   182   134   167   121    45     9    59    27   118    90   184     1   167    94   121    29    20    61    33   179   125   117    58   149    26    60   198    57    28    22   139   166    23   126    66    62   181   183    47   155    31   112   119   165    61   152    11    21    66    84   148    39    11    45    10   147   115    64    21    93    30   194    20   166    79     4   174   160   148   149    91
    55   111   193   143    80    40    13    70   144   121    13   123   115    44   184    43   161    94   126   103   146   155   132    42    30   131    20    93   108    20    29     2   131     5   101     1   154   178    38   162   173   101    80    14    40    14   163    63     6   104     4   190   135    35   194    10    76    18    81   188    28   118    22    36   115     1    71    67   120     7   118   162    82    10    98    79    74    32    63    79    83   120    21    92    92   105    58   127    38    42   148   129    49    14   110   121    63   198   198   145   191   109   195    46   125   157    88   126   183    56   193     5    46   112   126   142    78   106   129    33   114    96    33    31   166   156   163   150    26   174    29    88    98   186   196   113    67   133    80   120    89    58     1   198   128   185   156    80   103   172    64   135    96   146   197   140     5   162    34   164   121   170   135    14   124   187    99   183   183    84   157   183   136   147    92   123   109   167   134     2   173     3   123   177    64     6    85     4   146   143    78    97    58    78    99   104    60   156    57    30    57    59    30   128   109    14    94   143   187   101    65   178    58   158   182   108    23   158   142   140   164   145     8     2    48    36   175   164   171   125    64   148    39    47     2   113    44    95    27    20
    81     3   146   157    54    59   172   131     1   107   164   160   163    47   187    21   145   107   166    92   171    80     2   192   163   140   145   162     1   180   124    51   111    19   193    77    68   178   145    51     1    31   174    27    55   173     5    72    12   171   107   154   113     1   112   152    75    86     8    62    33    82   104     4    48    85    68    37   146   103   104   182   147    18    68   181    90   158    34    63   174   198   177    96   128     3   149     3    82   140   137   146    68   187    98     4   145   130   141   127    36   145    53    21    70   156    58     1    58   162   133     7   123     1    12   105   163    68   127    70     5   152   166    68    84    94   184    51    70   111    68    59   157    27   121    42   105    83    59    20   196   190    50   145    21   139    46   112    76    22    93    92   151   154    89    53    21   152   119   130   199    81   100   197    32    51    68   142     1   105    15    14   191   180    62   160    75    34   129   183    48   131    36   188    16    58   138   158    84   132     9   147   149    85   183    93    63   150    43   152    71    72    76   181    73    35    27   155   152   184    91    47   111   121   119    41    18   103    43   125   158   190     1   137    87    57     4    11    51   104    65   105   170   133   192   174    22   196   171    99
    12    39   161    79   110   129   127   154    17    99    24    43   108   106    29    22    88   188   160     4   128   142    80   126    25    74   138   168   127   137    55   150    32   138   136   130    36   163     1   120    30    21    38   123     1     5   169    24    83   111   145    58   174   120   135   149     1    26    78    48     3    58   185   149   139   126    68   181   123   188    35    85   154   148   173   195    56    51   178    30    48   129   197   134    56   114   127     9   171   170   163   199   181   189   159   163    42   135   117   197   180   102    97   176   105    70     1   182    21   189   164   124     1   123    18   191     6   196    53   152    29   153    68    40    99   152     1    42    46   123    34     8   174     2   123   171   134    73   132    11   146     3   116     4   166    89    20   108    15    37    36    56   113   128    18   147    72   158   113    97   171    47   170     3    74   194   188   122   176    76   105    19   161   107   144    90   144     1    45    26   114   143   161   122     1    31   159     4    32   121   131   189    97   176   145    88   154   173     5   145   122   111    88    17    18    31    57    71     9   152    55    76    15    84    28    77   179   171    78   114    14    19   163    73    79    22    25   116     6   101    50    38    47   119    37   119   183   125   127   160
   189    62    67    92    84     4     9   147    42   162   181    55    13    90    82   165   170   153    56     4    83    64    54   162   139   178    70     1    89   167    58    16    62    36    24   105    65     1    67    55    80   100     6    50   183    68   144    44   105    89    60    23   194    76     1    13    46   144   172     7   180    87   157    49   108   122   160   191     1   110     5    24   186    57   170    31   186   115   171    81    89    97    27   140   134    51   179    93   105    55   103   104   114    32    83   122   109    50   166   163   153    94   198   183   169   132    78     2    36   113    70    43    37   147    28   196   147    24   179   139    79    16   168    14    72    66   175    72   183   103   189    41   199   122     6    69    11   110   199   137    35   125   124   128     2    78   131   117    85    24     5    81   170   153   129    56    21     6   143    73   184    34    70    32    95   119    52    13   164    25   114   152   118   139   133   126    17     4    83    79    75   194    67   111   178   132   154   102    80   126    99   165   138   139    64   124    45   120    37   124    76   152     1    42   163   150    56    47    61   198   192    95   140    71    83   137     4   197    42    12    40   153   151   121   130   125   188    83   172   131   149    88    67    75    68   151   122   170    75   182
   172    34    41    16   179    85   182   188    14    13    76   151   140     3   121    75    82   142   179     3   143     3   189   127   151    50   113   113    41    46    39    11   191    40    57    81   183    66   190     4    22    25     6   152   192    76     2    89    63    25   103   190     3   107   186   196    61    34    96   111   131    65   153   185     4   104    39    14   105   176   171   118   182    27    30    37    13   134   155   130    61   141   169   187   177   174   161    52   142   177    48   172   160   109   172   133   108   143     5    90    29   162    92   199    89   156   136    18   182   115   136    59   109   134    37   158   146     8    42   187    27   114   181   190    90     1   171    68   197    99    44    90   106   149   174    35   167   153    49   118    80   195    49    38   188   142    45    95    32   133    61    60   127    10   133   116    75   105   151   109    41    28   177   115    34    50     6   109   170   124    27    46   110    73   133   164   112   197   158    30   123   157    73    97     3    62   133   121    37    87   168   139   186    86   102   150   163   190    21    86    77    49    63   149     2   198   182   102   120   161   100   153   197   117    51    73    14   113   155    45     2   119    33   177    85    77   174    42    70   105    54   198   111   132   125   104   129    15   176   112
   158    99    46    59   170    90     2   151   122   108   108   184    67   107   170    42   133     2    37    73   152   179    66   195    36   178   190   140    87   141   106   197    61   159   107     1    59   125    43    95   125   126    98   111    76   189    48    36   176    46   178    98   147     1    85    32   159    54    21   150   165   107    73   158   101    76   191   138   147   108    26   185    31    64   181   177    80    87   163   110    36   168    95   132   182   160    15   157    47     1   115   143     1     9   108     6   146     2   169    73    68   120   157    94   129     6   155   101   167    24   119    32   132   128     3    19    60    43    89    72    98    97     7    14    96   105     2   173     1   142    38   198     3    80    97    15   101    71   184    93    71    69     1     4   159     7   100   128   135   189    58     3    78   156    17    32   121     1   125    60   182   101    45   141    15   150    55    52     7    34    70    34    81   173    33   186   121    86    98   104   116    69    50   178   182   180   150   117    91    44   161    80   100    36    59   137   141   110     2   113    38   119   180    29    96    12    29   117     2   128    87   198   185    84    98    74   160   132   128    63    35   119   120   133    69   123    82   121    57     7   127    34   116    35    73   140   148   100   158   195
   166   121   157    21    41    17    14    95    84    32   155   118   139    30    94   113    19    65   194   147    78   100   147     1   177   181   108   182   123    19   137   104    53   114   158    66    72    61    47   166    98   166    57     1    11    75   100   153   156    56    59   144   125   174   199    19   119    76   122   122    84     1    32   105    21   173    34    59   186   142   173   104   140   112    20    39   146    13     1   124   132   193    88    33   151    20    43   174    97    51    69   109   116   129    95    95   164    49    88   106   188    87     4     7    55   167    69    75   138    70   166    65   101     3   122     1   199   100   174    38    60   101   141    34    17   164   155   146    46    69    52    13    17   151    94    19    21    33   194   162   125   133   136    21   117   184    64   127     1   140    93    40   111   178   177    48    67    98     3    98    18     4   155    11     2   153    37   199   167   100   153   166   137   169    22    90   191   129    69    53   183    85   105   121   110   178    87   100    14   128   122   175   180     1    50   191     8   154   128    19   134    18    10    94    37    14    88    14    64    28    28     1    46   135   153     3    72   142   164   119   120   121    82    79   194    83    66   173    89   178   154   149   104   195    15   183    94   151     4    28
    76   132   150   164   173    77   182    73   125    40   161   134    77   111    11   171   132    76     5    60    59   158    73   148    16   131    79   185   177   127    34    35    88   178    32    52    76    90    56    85   110    97     1     2    52   131    68    22   197    80   135   173    33   111   192   102    47   154   165   134   199    88   184   150     6   103     5     2    77     4     6   152   128    85   176   143    39    73    63   179    66   136   147   146    51    77    59   178   186    76    50   114   149     3    28   179    26     1    79   141    96   188    30    30   174   127   162    10   157   127    17   147   119    82   112    56    89    15   100   120    84    40    79    29    18     3    53    68    67   140    49    14    40   131   124    38     1     1   158   166    81    27    25   111    53   144   149   113   151   198    32    64    52   142   191   108   188     9    10   152   143    12    85    42    81   191    35   178    72     3    48     1    82    87    79   120   171    68    58    34   170   189   142    14   155   185    43   152   176    62    57   195   136    41    14   158    96   186   124     9    49    28   101    79    49   127   198    15   150    38   121   180    12   173   151    57   119    88   120   175   147   122   140     5    96   166    69     2    95    27   116    40    93   156   177   176    67    71   110    20
    59   106   145    98    73   133   186   117    15   185   146   176   154   183   172   183    76   186    45    44   152   109    24   131    54     4    90    20   198    47   107    51    26   160   139    65   109    38    11    92    53   196    22   161   175    95   193   108   175    99   181    40    47    46   142   193   192    73    77    32   109   135   178    37    83   190    29   132    49    59    52     2   115   166   118   188    44    45    20    51    60   191    45   130    11    65   170    72     8    57    43   184     1    48    44    57   191   164   192   108    79     8    68   103   111    89     6    16   141    86   127    65     7   120    55    29   146    26    46   113   196   136    46    65   105    58    73   173   168   119    84   170     9    35    62   100    12   129   177   116   153   180     7   167     3   139   151    49   174   191     6   176    18     2    44     9   188   163    87    22     2   115    56    55    76    26   100    45   175   155   164    85   147   156   126   101    85    51    54   164   143    29     1    84    43    65   128   112   157    75   131   169    93   158    82   188   111    11    87   113   163    12   172   109    75   119     4   174    66   150     1    38    32    11    51   123   141    39     3     5   110    90    43    51   168     3   139   110   114    91   151     9   121     5    87    62    12    39    69    24
