    33     9    74     8    17    88    43     7    11     6    30     1    21    88    62    89    10    78    49    63    70    39    26    20    96    20    12    20    56    16    58    95     6    80    96    76    87    11    23    31    44     5     1    53    54    29    94    48    30    58     3    92    30    90     4    52    27    50    73    13    48     4    62    77    27    24    33    93    82    23     8    71    41    90    83    54    57    41    47     2    68    96    16    99     7    84    68    91    83    49    36    67    37    40    64    21     2    33    86    95
    64    75    96    29    70    89    35    61    78    89    57    53    70    95    47    18    70    36    66    97    60    95    46    43    39     2    65    79    31    15    89    21    69     3    40    55    92    14    31    88    25    41    67     1     7     9     9    10    65     7    11    79    46    72    33    73    39     7    41    32    64    26    16    81    45    41    10    66    59    86    63    23    74    63    24     4    17    58    99    84    45    34    97    47     2     6    63    83    26    59    23    64    87    28    53    44    52    32    16     7
    65    42    73    10    26    68    65    42     5    24    81    15    16     1    53    97    72     1     1     1    32    60    81    61    55    81    55    57    35    24    89    23    69    97    87     1     5    88    36    78    83    34    56    87    34    46    43    61    87    81    52    52    31    64    18    93    40    82    73    56     5    91    79     1    51    14    88    16    95    97     1    48    11    85    34    64     7    75    65    44    49    97    26     3    15    52     1    69    49    97    61     1     3    95    34    87    17    40    83    17
    17    70    80    82    32    29    77    62    16    33    54    55     1    49    94     2    26     1    40    74    15    18    84    88    26     5    16    89    51    17    81    28    22    87    19     1     4    18    12    98    33    88    87    55    98    10    13    82    22     1    92    75    66    55    90    38    97     4    77    42    54    19    25    31    97    37    98    73     4    58     4    93    71    86    90     1    64     1    67    39    50    11    48    15    76    72    91    78    30    43     1    41    45     6    98    50    37    10    34    14
    67    94    33    49    40    91    73     7    92    34     6    91    16    52    76    22     2     1    27    65    60    99     1    99     1    96    31    80     5     5     1     5    65    15     3    80    52    83    22    87    62    55    97    23    59    51    72    38    18    40    78    18    73    74    95    24     1    92    93    83    81    69    57    10    72    45    13    65    82    18    46     4     1    90    57    24    12    81    25    96    95    83    99    51    63    91     1    70    17     2    18    60    30    47    12    23    54    49    84    32
    16    90    20    80    80    23    94    26    43    96    70    43    68    11    71    18     4    19    94    80    61    78    56    83    56    32    95     6    74    61    33    29    20    10     3    30    42    77    44    89     4    78     1    54    23    26    17    63    25     7    76    28    87    72     7    57    43    26    91    56    78    20    67    34    61    29    84    43    11    79    26    58    20    36    80    39    67    63    71     9    54    85    46    60    46    97     9     2    21    43    54     1    86    12     4    11    67    71    90    81
    42    55    23    57    20     6    75    74    92    61    33    96    58    80     1    56     9    77    33    51    71    10    70    57    97     1    30    64    90    77    62    14    93    50    49    85    75    81    18     2    89    95    73    85     3    38    27    69    76    59    36    82    57    35    69    32     1    81    15    92    79    37    43    20    69    60    47    88    23    29    78    96    48    64     1    14    34    31     1    59    66    54    78    61    47    44    50    90    44     2    66    31    77    39    21    23    71    48     3     8
     2     1    78    48     2    86    47    86    98    80    69    46    66    72    32     3     1    40    73    37    90    72    91    24    44    25    26    10    51    34    30     6    70    15    28    15     5     2    76    87    14    77    62    70    65    37    38    95    35    41    16    82    11    34    29    20    93    91    70    46    18    45     6    13    79    99    44    84    32    74    87    99    46    73    58    35     3    72    24    35    23    72     2     1    80    29    37    75    56     3    50    41    28    81    50    11    42    76    70    15
    20    19    75     5     6    63    36    54    11    21    38    11    59    44    38    33    95    71    36    26    53    69    92    48    43    75    44    66    74    18    45    78    83    10     1    97     2    84    11    36    70    29    16    94     1     1    77    79    18    29    92    35    32    34     1    57    68    42    64    83    95    28    36    66    79    64    73     3    97    63    89    29    19    99    74    73    81    21     1    38     2    51    15    51    31     1     5    88    80    62    59     3    85     3     7    49    10    76    39    35
    84    31    72    48    75     4    58    61    88    27    77    16    90    85    93     4    67    32    12    48    29    35    10    58    55     8    13    84    20    32    19    67    55    50    11    39    26    72    54    30    74    11    23    59    59    23    36     1    31    43    89     3    34    80    66    64    54    12    57    71    20    93    22    26    23    48    22    22    88    89    36    92    27    52     1    80    20    54    82    21    85    47    34    25    99    39     8    47    10    21     3     1    97    73    13    85    52     8    23    59
    71    17    87    99    72    91    38    59    49    75    28    25    22    41    47    57    31     1    96    95    26    56    15     2    34     5    28    93    63    91    41    12    39    12    17    69    10     1    20    46    69    95    39    68    85    30     9     3     5    32    85    13    44    19    68    12    39    59    75    97    27     6     1    12    93    70    32    77    35    80    90    98    18    86    62    69    10    54    90    50    17    81    80     1    39    68    67    69     2    29    91    95    35    73    71    79    80    57    35    78
    27    49     9    96    20     1    13    27     6    92     2    40    21    66     7    80    73    89     2    30    65    95    16     1    14    98    73    11     1    29    19     4    86    63    51    34     7    24    91    72     2    49    14    85     5    79    76    52    14    53    63    98     1    95    97    76    59    92    73    83    39    40    51    46    41    84    60    73    52     7    80     1    74    71    24     3    60    73    58    30    95    60    74    74    78    77    39    94    96    16    95    14    71    30    90     8    57    48    29    11
    40    60    37    35    29     7    44    49    82    59     5    78    10     9    12    22    85    50    45    55    70    54    21    27    62    52     1     2    38    36    55     1     1    83    86    26    86    50    29     6    53    72    65    37    76    59    26     1    16     1    71     5    42    17     6    80    52    52    69    35    90    73    33     2    87    96    58    21     1    21     3    94    68    54    37    58     2    82    34    92    18    43    84    97    78    34    99    35    66    32    90    17    52    99    70    68     2    50    44     5
     6    66     7    35    64    91    89    22    12    67    14     1    11    66    50    65    64    79    30    47    37    39     1    49    27    17    90     3    65    38    22    12    15    48    58    91     2    34    34    57    72    86    34     8    74    23     2    43     1    44    96    24    63     2    63    64    17    76    72    24    97    19     7    29    24    68    74    54    57    29    68    28    81    57    64     7    81    13    51     1    90    94     1    58    35    81    37     1    82    73    36    66    95    44    98    57    14    20    58    82
    94    53    52    91     2    93    37    91    90    88    21    65    82    38    73    81    41    54     7    28    89    45    77    80    29    25    61    61    52    54    90    52    40    98    26    53    34    96    12    84    30    20    12    37     6    96    88     1    90    67    13    88    61    14    91    61     2     1     5    46    15    22    75    45    44    95    78    59    25    85    24     5    51    92    90    10    61    95    81    66    76     4    92    16    66     3    81    74    35    32    28    91    98    73    74     1    39    68    30    49
    86    98    39    89    42    70    97    16    38    15    29    16    37    20    94    96    71    22    24    63    25    10    70    46    19    60    18    91    40    10    68    76    11    56     1    14    38    83     2    84    51    63    20     3    98    23    99    10    65    51    28    67    52    88    22    11    85    29    98    45    18    11    96    98    30    16    79    98    87    88    19     6    24    92    26    98    66    77    30    32    14    56    69    34    78    17     1    18    68    51    10    48    79    14    53     1    13    46     8    51
    79    42    77    40    45    18    54    60    54    11    99    92    21    60    18    51    76    84    43    15    89    10    51    10    53    66    63    50     1     2    32    81    62    59    29    20    94     8    77    52    89    13    86    97    16    98     5    94    82    23    18    57    38    37    76     3    13     7    39    49    88    16    96    39    18    63    78    46    80    95    94    21    57    60    66    55     3    10    23    72    34    92    34    62     3    13     2    28    59    45    65    63     9    58    36    16    49    99    57    83
    83    86    17    27     8    54    97    53    77    13    84    93    56    25    63    46    39    60    68    81    90    38    30    90    68    78    50    96    33    81    43    25    49    49    58    27    37    53    68    85    29    72    67    56     9     2    97    31    42    55     3    24    86    79    49    51    86    90    55    34    19    24    71    31    66    30    80    64    10    34    39    70    34    60    33    49    47    77    78    63    94    78    63    35    83    22    40    81    83    34    35     6     1    91     1    35    30    74    94    42
    38    75    92    55    38    39    55    49    80    33    29    14    85    60    28     2    29    12    56    12    65    44    44    68    17    92    75    68    26    45    45    60    55    67    85     1    65    23    80    55    67    93    19    67    51    98    52    24    99    55    34    69    51    54    98    94     3    68    29    86    71    26    80    15    33    83    37    28    38     1    35    85    25    71    73    79    89    57    93    98    48    76    75    52    63    52     4    94     8    81    58     9    28    98     1    76    42    51    59    49
    29    14    80    42    66     8    91    81    73    50    70    41    91    19    53     2    76    43    68    69     2    46    15    83    53    54    85    12    32    99    56    27    26     9    59    91    47    76    37    44    90    61    71     1    96    59     1     3    54    51    55    54    95    38    39    55    26    94    87    85    94    59    44    40    30    87    69    67    32    92    82    27    21    24    92    41    28    61    34    81    39    68    22    84    44    75    15    56    63    89    83    14    14    25    83    69    98    63    14    36
    83    28    92    89    98    49    11     6    52    11    40    60    84    69    56     1    79    13     1    75    70     9    28    23    99    20    68    28    70    69    13     2    94    90    47    96     1    88    32    12     4    99    49    93    36    77     9    55    43    12    71     2    87     1    29    88    66    14    94    15    56    76    19    65    63    61    79    88    85    77    17    88    46    45    10    86    51    82     1    45     1     1    32    44    61    16    88    57    68    31    32    18     4    73     1    93    80    19    27    45
    35    33    71    85    23    10    72    54    21    92    22    85    74    53    63    36    59    49    21    18    77    99    54    70    70    85     2    53    59    81    19    47    82    62     7    38    24    16     3    23    75    88    17    42    86    79    40    75    95    10    18    50    20    68    60    54     8    15     5    90     1    55    31    55    57    49    46    91    92    81    19     1    76     3     7    54     1    45    99    36     8    92    23    64    89    75    91    12    88    72    56     1    99    69    64    36    25    72    15    48
    88    83    78    20    78    40     1    16    87    74    23    47    84    29    83    73    83    26    96    88    12    36     1     9    32     1     9    79    11    55    72    83    51    48    13     5     1    13     6    28    64    20     1    99     1    50     4    61     6    79     2    10    62    76    73    71    78    75     9    10    96    95    17    62    97    84    48    75    21     6    41    25    46    88    93    47    48    63    70    53    95    24    10    27    77    68    29    35    53    47     1    61    24    59    63    19    38    85    34     8
    36    38    39    86    52    66     8    20    97    46    53     5    78    29    80    30     1    44    63     8    33     1    63    63    59    59    69    16     8    42     1    42    61    89    61    26    34    21    41    40    33    20    60    96    98    39    39    67    90    44    74     3    13    23    61     2     8    78    74    88    72    15    89    89     5    24    67    25     2    11    85    38    80    71    94    14    74    25    58    70    42     2    88    87    24    80    10    63    36    26    61    56    15    64    26    60    59     1    20     9
    87    36    46    36    10    79    21    92    57    85    45    86    56    80    28    22    86    84    81    27    15    71    44    23    56    93    18    69    34    36    33    46    73    65    25    87    69    29    52    49    39     1    38    71    14     1    86    16     9    30    24    41    80    35     1    29    37     1    28    59    50    49    85    25    14    85    70     5    42     8    52    28    25    76    16    22    79    56    83    54    80    23    91    55    41    12    18    43    86    12    73    27    12    81    89    56     5     1     7    52
