    81   200   235   209   194    43   237   169    91    64    27   125    37    68   105    50   202    48   113    43    24   190    53   230   193   168   168    25    37   201   230   239   144    68    15   135   169    26    99    70    16   226   134    42    72   209     1   199    48   214   107    11   151    95   130   131    88    56    21   152    72   103   123   204    67    72   210   211   163   138    66   160    71   182   136   115   136    27     4    83    65   152    40    77   105   198   205   213   217   140
   155    85   102    23   137   170    56    45    32   179   188    51    28     5   232   168   177   145    19   134   168   142   202     5   123   144   186    24    38   139    95   169   160   176   154    75   143     6    46    34   165   196   142   124   204   221    57    21   219     5    61   181    32    35   204    18   208   237   183   167   156   229    55   151   197   110    48    89   233    77    94    21    17   176   221   154     1    39   123    50   108   136   151   146   212   142   222   228   194   231
   157   213   206    89   117    62   187   130   106   207    13   209    32    12   111    40   202    62    29     9   174   200   144   108    89    76    31    91    50    59   134    78   188     4    25    86    27   195   134    14   167   122   119   207    38    13     3   127    70   210   199   153   173   157   168    82     3     5    64   228   210    16   133   172   197    75   149   190    14    48    96   188   217   166   111    14   232    59    81    32   123   233    73   141   201   229    52    83     7   239
    42    87   181    17    13    77   125    94   215   130    39   234    80    34    28     1   189   146   121    80    63     1    29    72    63    38    81   107     1   115    62   142   220   218   159   123    19   108    54   188    53   146   162   140   233    10    83    57    82    87    79    81   225    82   226   237   236   236     6   190    54   217   133   231    85   159    31   130   152   137   234    21   165   174   201   130   173    64    18   158   234    12   200   179     8     9     5     2   163    71
   162   211    35   127   116    97    25    21    90   147   222   137   122    52    38    39   134    47   175    11     5   207   104    17   116   145    37   112   186   139     2   135   131   147   203    13    82   239   217   160   156   176    22    64    95   125   166   183    29    73   149    93   148    30   142   141    35   141   211     1    43    22   122    32     7   177   193    91   220   154     1    89   227    14   172   196   122   142   180    63   174    34   211   188    54   196   102   221    57   222
    40    22    68    95   238   193   211   118   233   142   105    14    28    70    62   165   213   167   226   138     9   188    33    58   229   147    95    23   169     6   134    48    48    44   224   179    40   167   163    30    49   192   216     2   165   102    28   213     5   110    10    14   239    48   165    55    71   186   237     8    62   140    30    67    32   209   216     2    53    29   103   120    34   236   234   187    11   183   231    30   146    59   146   190   186    28    55   185    47   235
   101   180    81   186   231    48   214    24   131    65   222   213   223   238    96   140   230   129    44   193    23    87   117   105    72   172   228   239   122     1   233     5   204   153    27   217    36   195    76     9   223     8   150    70    83   180    34    39   185   175   215    98   211   206   205     7    23   191    13   126   183    17    26    44   237   138   173   163   183   183     1    17    36    95   199   191    64   133   231   111   167    98   118   188   175    55   208   196   227     1
     5   100   199    42    85     4   163    96   233   118   235    58   179   203   188   159     2    71   153    54     3     1    63   164   134   217   146    88    72    66   107   195     2   122     6   122    58   134   103     1   169   233   116   141    63    13   212    32   163    16    34    82    49   162    90   157   111   122   233     1    85   196   191     7    14    26   155   183   118   193   224   199   180   134    85    43   220   229   172     7   190    35   201   193    52    76   233    16    94   227
    48   169    92   222    86    16    70   159   133    53    26    80   111    69     2   143   119    71    67   158   229     1   106   135   114   127    44     1   106   119   105    12   143   182     7   178    42   102   108    31   199   209   215   205   219     6    45    52   194   138   169   212    48    46    19     3    25    93   126   104    44     1   105    83    58    77   132    55   235   154   164    10   188    71    58   228    47    37   194    71   190    90    59    90   130   233   139    28    86    67
   201   227    88   192   218   181   220   191   218   218   212    83   206   168   158   216   126   194   127   195   162     1   201   164    67    70   239   171    36   193   132   231   224   204   147    49    14    86   136   125   132    36   156   141   128    63   199    69    89   201   177   133     3   171    91   143   124     1     1     3    74    96    73   133   212    83   177    85    95   147   130   220     3   209   111    48   167   118   106   109    56   108   205   166   142   211    44    19   198    13
   172   216   178   221   214   174    55   105    26    38   118   230    73    96    40    54    27   149   135   232    74    46   119     2   152    64   187    64    69   111    83    76    28   165   220   151   147   141    32   184    94    24   231   113    35    25   185    55    77   203   167   189     2   119     7   205    62   227    22    24    13    18     7   172   162   107   173    11    71    28    95    63   177   225   108    67    48   150    47   236   224    69    80   190   236    84   190    20    40    14
    66   133   232   172    96    48    15    84   173   145    16   147   138    53   221    52   194   113   151   124   176   186   159    50    36   157    24   112   129    24    35     2   157     6   121     1   184   214    45   195   207   121    96    17    48    17   196    75     7   125     4   228   162    42   233    12    91    21    97   226    33   142    26    44   139     2    86    80   144     9   141   195    98    12   117    94    89    38    76    95   100   144    26   111   111   127    70   153    46    50
    97     3   175   188    65    71   206   158     1   128   197   193   196    57   224    26   174   129   199   110   206    96     2   230   196   169   174   194     1   216   149    61   133    23   232    93    82   213   174    61     1    38   209    32    66   207     6    87    15   206   129   184   135     1   134   182    91   104     9    74    40    98   124     5    58   103    82    44   176   123   124   219   177    21    82   217   108   190    41    76   209   238   213   115   154     4   179     3    99   169
    14    46   193    94   132   155   153   184    20   118    29    51   129   127    35    26   106   225   192     5   154   170    96   151    30    89   165   201   152   165    67   180    39   165   163   157    44   196     1   144    37    25    46   148     1     6   203    28   100   133   174    69   209   144   162   179     1    31    94    57     4    70   222   179   166   151    81   217   148   226    42   102   184   178   207   234    68    61   213    36    58   155   236   160    68   137   152    10   205   204
   227    74    80   111   101     5    11   176    51   195   218    66    15   109    99   198   204   184    67     4   100    77    65   194   167   213    84     1   107   200    70    20    74    43    28   126    78     1    80    67    96   120     7    61   220    82   173    53   126   107    72    27   233    91     1    15    56   173   207     9   216   105   188    59   130   147   192   229     1   132     6    29   223    69   204    38   224   138   205    97   107   117    33   168   160    62   215   112   126    66
   207    41    50    19   215   102   219   225    17    16    91   181   168     4   145    90    98   171   215     4   172     3   227   153   181    60   136   136    50    56    47    14   229    48    69    98   219    80   228     5    26    30     8   182   230    91     3   107    76    30   123   228     3   129   223   235    73    41   116   133   157    78   184   223     5   125    46    17   126   212   205   141   219    32    36    44    16   161   186   156    73   170   203   224   213   209   193    63   170   212
   189   119    55    71   204   108     2   182   147   130   130   220    80   128   204    50   160     2    44    87   182   215    79   235    43   213   228   168   104   169   127   237    73   190   128     2    71   150    52   115   150   151   118   134    91   227    58    43   211    56   213   118   177     1   102    39   191    65    26   180   198   129    87   189   121    91   230   166   176   130    31   222    37    77   217   213    96   104   195   132    43   201   114   159   218   193    19   188    57     1
   199   145   189    25    49    21    17   114   101    38   186   142   167    36   113   135    23    78   233   176    94   120   176     1   213   217   130   218   148    23   164   125    64   137   189    79    86    73    56   199   117   199    69     1    13    90   120   183   188    67    71   173   150   208   239    23   143    91   146   147   101     1    38   126    25   208    41    71   223   171   207   125   168   135    25    47   175    16     1   149   159   231   106    40   182    24    51   209   117    61
    91   158   180   197   207    93   219    88   150    48   194   160    93   133    13   205   159    91     6    72    71   190    88   178    19   158    95   222   212   152    41    42   105   214    39    62    91   108    68   102   133   116     1     3    63   157    82    26   237    96   162   208    40   134   230   123    56   185   198   161   239   106   221   180     7   124     6     2    92     5     8   182   154   102   211   172    47    87    76   215    79   163   176   175    62    93    71   214   224    91
    71   128   175   118    88   160   223   140    18   222   176   211   185   219   206   220    91   223    55    53   182   131    28   157    65     5   108    25   238    56   129    61    31   192   166    78   130    46    14   111    63   235    27   194   210   114   232   129   210   119   218    48    56    55   170   231   231    87    92    39   131   162   213    45    99   228    35   159    59    71    63     2   139   199   142   226    53    54    24    61    72   229    54   157    14    78   205    87     9    68
