    30    15    64    77    75     8    81    15    88    25    67    18    78    35    83     7    72    89    80    80    16    72    65    38    88    79    20    82    63    44    39    84    34    87    10     6    24    53    14     6    10    39    44    34    47     5    86    68    13    10    27    63    25    26    36     1    39    23    15    54    18    62    20    33    75    80    10    37    18    62    56    64    42    85    50    80    16    51    87     1     9     3    27    64    71    70    17     1    20    12    44    85    86    21     1    57    72    86    57    68    63    55    24    22    63    35    70    51     9     8    24    51    14    63    26    18    75     2    41    21    86    50    31    17    89    18    28     5    54    18    10    86    25    16    61    18     5    84    82    25    50    67    56    36    63    15    55    82     9    62    53    30    37    61    12    85    26    11    69     2     6    18    35     9    85    72     9    11    50    81    86     3    16     1    42    68    27    62    13    86    78    38     9    34     1    10    69     1    74    80    20    40    18     1    28    28    80    41    76    11
    58    37    24    71    32    67    50    44    38    30    87    20     8    70    64    26    51    86    36    76    63    18    18    40    21    80     5     1    16     9    31    68    12    49    65    55    67    24    54    48    70    83     6    48    19    80    55    82    10    83    51    30     2    89    19    48    87    36    83    76    63    52    19    19    66    86    72    60    54    48    42     1     7    16    56    16    50    72    46    32    63     8    66    68    53    32    70    80    75    44    59    29     2    39    19    88    46    27    13    16    54    64    59    80    69    85     9    85     9    89    42    63    14    45    48    39    52     1     9    63    35    87    13    47    63     1     1    88    60    76    59    27    66    57     2    71    57    10    45    48    28    81     1     1    53    13    69    26     2    73    80    56    17    28    17    19    12     3    73    43    62    83    77    56    73     3    45    56    53    56    36    44    46    26     6    50    76    31    18    34    82    67     6    85    21    12    73    22     7    14    28    16    82    69     2    79     2    65    46    21
    58     1    36    74    79    37     1    54    77    74    65    71    33    15    70     9    43    31    24    18    23     1    26     8    70    61    77     6    49    36    59    42    39    87     1    38    77    44    48    14     4    88    73    70    78    22    72    53    12    67    73    62     4    76    21    13    41    70    84    42    15    59     9    50    75     1    65     8    23    26    48    29    11    57    74    87     3    20    41    66    65     1    77    35    75     1    36    45    54    23     1    66    40    61    86     1    33    50    73    80    28    81    63    81    11    54    65    48    34    33    73    82    19    27     1    55    22    24    81     8    50    40    55    61    29    73    23    46    70     1    50    24     1    45     8    51     9     2    87    71    32    46    35    29    10    22    30    32    73    50    80    27    50    38    65    21     5     1    23    74    62    63     1    44    45    87    14    74    44    43    78    25    77    52    12     1    14    23    25     5     5     5    77    34     1    79     2    45    47    12    32    68    26    61     5    70    78     6    77    25
    15    18     5    34    32    63    17    59    67    34    72    67     6    83    35    74     5    32    49    77    29     6    58    35    46    26    57    82    35    59    69    33    80    50     7    56    48    20    44    18    14     9    11    72    87    30    19    60    30    41    48    34    12    26    47    49    10     1    13     4     1    53    10    76    71    44    39    59    54    26    84    34    45    25    72     2    30    59     2    27    23    86    58    26     1     1    64    71    11    40    36    33    27    50    56    66    23    42    11     7    14    47    33    59    30    16    62    35    40     1    75    83     1    39    57    79    43    44    62    57    23    39    25    15    53     4    67    16    82    53    14    39    81    68    62    80    59     2    61    14    46    66    58    23     7    15    16    34    40    38    73    40    20    40     1    25    70    11    54    38    20    74    13    49    55    78     9    43    60    80    17     1    52    76    55     1    87    82     1    23     3     2     2    58    31    16    76    30    21    19    10    10    31    72    37    89    32    51    50    36
    60    75    85    26    79    85    27    48    13    33    30    65    47    72    41    44    43    82    38    33    36    68     2    60     9    82     4    83     8    71    66    52    33    82    19     7    55    81    73    83    83    79    81    66    51    31    24    79    45    77     5    69    19    63    40    82    14    59    37    77    14    81    74    82    50    47    76    34    17    72    69    83    65    47    25    20     4    73     1    20     2    61    37    68    77     1    28    49    39    75    24    10     6    61    72    59    43    25    62    24    54    26    80     2    14    89    31    40    42    64     1     9    69    13    40    89    52    72    75    21     1    49    26    48    50    86     7    23    49    84    27    11    55    76    16    72    76    55    10    62     5    18    47    29    31     5    29    49    89    32     1    17    81    51    30     5    60    47    25    41    58    49    36    23    66    13    45    88     8    58     2    10    24    53    22    72    35    48    82    78    47    23    30    43    62    74    65    87    68    26    20    48    11    33    47    79    27    75    40    44
